CIDADE	ESTADO
Alta Floresta D'Oeste	Rondônia
Alto Alegre dos Parecis	Rondônia
Alto Paraíso	Rondônia
Alvorada D'Oeste	Rondônia
Ariquemes	Rondônia
Buritis	Rondônia
Cabixi	Rondônia
Cacaulândia	Rondônia
Cacoal	Rondônia
Campo Novo de Rondônia	Rondônia
Candeias do Jamari	Rondônia
Castanheiras	Rondônia
Cerejeiras	Rondônia
Chupinguaia	Rondônia
Colorado do Oeste	Rondônia
Corumbiara	Rondônia
Costa Marques	Rondônia
Cujubim	Rondônia
Espigão D'Oeste	Rondônia
Governador Jorge Teixeira	Rondônia
Guajará-Mirim	Rondônia
Itapuã do Oeste	Rondônia
Jaru	Rondônia
Ji-Paraná	Rondônia
Machadinho D'Oeste	Rondônia
Ministro Andreazza	Rondônia
Mirante da Serra	Rondônia
Monte Negro	Rondônia
Nova Brasilândia D'Oeste	Rondônia
Nova Mamoré	Rondônia
Nova União	Rondônia
Novo Horizonte do Oeste	Rondônia
Ouro Preto do Oeste	Rondônia
Parecis	Rondônia
Pimenta Bueno	Rondônia
Pimenteiras do Oeste	Rondônia
Porto Velho	Rondônia
Presidente Médici	Rondônia
Primavera de Rondônia	Rondônia
Rio Crespo	Rondônia
Rolim de Moura	Rondônia
Santa Luzia D'Oeste	Rondônia
São Felipe D'Oeste	Rondônia
São Francisco do Guaporé	Rondônia
São Miguel do Guaporé	Rondônia
Seringueiras	Rondônia
Teixeirópolis	Rondônia
Theobroma	Rondônia
Urupá	Rondônia
Vale do Anari	Rondônia
Vale do Paraíso	Rondônia
Vilhena	Rondônia
Acrelândia	Acre
Assis Brasil	Acre
Brasiléia	Acre
Bujari	Acre
Capixaba	Acre
Cruzeiro do Sul	Acre
Epitaciolândia	Acre
Feijó	Acre
Jordão	Acre
Mâncio Lima	Acre
Manoel Urbano	Acre
Marechal Thaumaturgo	Acre
Plácido de Castro	Acre
Porto Acre	Acre
Porto Walter	Acre
Rio Branco	Acre
Rodrigues Alves	Acre
Santa Rosa do Purus	Acre
Sena Madureira	Acre
Senador Guiomard	Acre
Tarauacá	Acre
Xapuri	Acre
Alvarães	Amazonas
Amaturá	Amazonas
Anamã	Amazonas
Anori	Amazonas
Apuí	Amazonas
Atalaia do Norte	Amazonas
Autazes	Amazonas
Barcelos	Amazonas
Barreirinha	Amazonas
Benjamin Constant	Amazonas
Beruri	Amazonas
Boa Vista do Ramos	Amazonas
Boca do Acre	Amazonas
Borba	Amazonas
Caapiranga	Amazonas
Canutama	Amazonas
Carauari	Amazonas
Careiro	Amazonas
Careiro da Várzea	Amazonas
Coari	Amazonas
Codajás	Amazonas
Eirunepé	Amazonas
Envira	Amazonas
Fonte Boa	Amazonas
Guajará	Amazonas
Humaitá	Amazonas
Ipixuna	Amazonas
Iranduba	Amazonas
Itacoatiara	Amazonas
Itamarati	Amazonas
Itapiranga	Amazonas
Japurá	Amazonas
Juruá	Amazonas
Jutaí	Amazonas
Lábrea	Amazonas
Manacapuru	Amazonas
Manaquiri	Amazonas
Manaus	Amazonas
Manicoré	Amazonas
Maraã	Amazonas
Maués	Amazonas
Nhamundá	Amazonas
Nova Olinda do Norte	Amazonas
Novo Airão	Amazonas
Novo Aripuanã	Amazonas
Parintins	Amazonas
Pauini	Amazonas
Presidente Figueiredo	Amazonas
Rio Preto da Eva	Amazonas
Santa Isabel do Rio Negro	Amazonas
Santo Antônio do Içá	Amazonas
São Gabriel da Cachoeira	Amazonas
São Paulo de Olivença	Amazonas
São Sebastião do Uatumã	Amazonas
Silves	Amazonas
Tabatinga	Amazonas
Tapauá	Amazonas
Tefé	Amazonas
Tonantins	Amazonas
Uarini	Amazonas
Urucará	Amazonas
Urucurituba	Amazonas
Alto Alegre	Roraima
Amajari	Roraima
Boa Vista	Roraima
Bonfim	Roraima
Cantá	Roraima
Caracaraí	Roraima
Caroebe	Roraima
Iracema	Roraima
Mucajaí	Roraima
Normandia	Roraima
Pacaraima	Roraima
Rorainópolis	Roraima
São João da Baliza	Roraima
São Luiz	Roraima
Uiramutã	Roraima
Abaetetuba	Pará
Abel Figueiredo	Pará
Acará	Pará
Afuá	Pará
Água Azul do Norte	Pará
Alenquer	Pará
Almeirim	Pará
Altamira	Pará
Anajás	Pará
Ananindeua	Pará
Anapu	Pará
Augusto Corrêa	Pará
Aurora do Pará	Pará
Aveiro	Pará
Bagre	Pará
Baião	Pará
Bannach	Pará
Barcarena	Pará
Belém	Pará
Belterra	Pará
Benevides	Pará
Bom Jesus do Tocantins	Pará
Bonito	Pará
Bragança	Pará
Brasil Novo	Pará
Brejo Grande do Araguaia	Pará
Breu Branco	Pará
Breves	Pará
Bujaru	Pará
Cachoeira do Arari	Pará
Cachoeira do Piriá	Pará
Cametá	Pará
Canaã dos Carajás	Pará
Capanema	Pará
Capitão Poço	Pará
Castanhal	Pará
Chaves	Pará
Colares	Pará
Conceição do Araguaia	Pará
Concórdia do Pará	Pará
Cumaru do Norte	Pará
Curionópolis	Pará
Curralinho	Pará
Curuá	Pará
Curuçá	Pará
Dom Eliseu	Pará
Eldorado do Carajás	Pará
Faro	Pará
Floresta do Araguaia	Pará
Garrafão do Norte	Pará
Goianésia do Pará	Pará
Gurupá	Pará
Igarapé-Açu	Pará
Igarapé-Miri	Pará
Inhangapi	Pará
Ipixuna do Pará	Pará
Irituia	Pará
Itaituba	Pará
Itupiranga	Pará
Jacareacanga	Pará
Jacundá	Pará
Juruti	Pará
Limoeiro do Ajuru	Pará
Mãe do Rio	Pará
Magalhães Barata	Pará
Marabá	Pará
Maracanã	Pará
Marapanim	Pará
Marituba	Pará
Medicilândia	Pará
Melgaço	Pará
Mocajuba	Pará
Moju	Pará
Mojuí dos Campos	Pará
Monte Alegre	Pará
Muaná	Pará
Nova Esperança do Piriá	Pará
Nova Ipixuna	Pará
Nova Timboteua	Pará
Novo Progresso	Pará
Novo Repartimento	Pará
Óbidos	Pará
Oeiras do Pará	Pará
Oriximiná	Pará
Ourém	Pará
Ourilândia do Norte	Pará
Pacajá	Pará
Palestina do Pará	Pará
Paragominas	Pará
Parauapebas	Pará
Pau D'Arco	Pará
Peixe-Boi	Pará
Piçarra	Pará
Placas	Pará
Ponta de Pedras	Pará
Portel	Pará
Porto de Moz	Pará
Prainha	Pará
Primavera	Pará
Quatipuru	Pará
Redenção	Pará
Rio Maria	Pará
Rondon do Pará	Pará
Rurópolis	Pará
Salinópolis	Pará
Salvaterra	Pará
Santa Bárbara do Pará	Pará
Santa Cruz do Arari	Pará
Santa Izabel do Pará	Pará
Santa Luzia do Pará	Pará
Santa Maria das Barreiras	Pará
Santa Maria do Pará	Pará
Santana do Araguaia	Pará
Santarém	Pará
Santarém Novo	Pará
Santo Antônio do Tauá	Pará
São Caetano de Odivelas	Pará
São Domingos do Araguaia	Pará
São Domingos do Capim	Pará
São Félix do Xingu	Pará
São Francisco do Pará	Pará
São Geraldo do Araguaia	Pará
São João da Ponta	Pará
São João de Pirabas	Pará
São João do Araguaia	Pará
São Miguel do Guamá	Pará
São Sebastião da Boa Vista	Pará
Sapucaia	Pará
Senador José Porfírio	Pará
Soure	Pará
Tailândia	Pará
Terra Alta	Pará
Terra Santa	Pará
Tomé-Açu	Pará
Tracuateua	Pará
Trairão	Pará
Tucumã	Pará
Tucuruí	Pará
Ulianópolis	Pará
Uruará	Pará
Vigia	Pará
Viseu	Pará
Vitória do Xingu	Pará
Xinguara	Pará
Amapá	Amapá
Calçoene	Amapá
Cutias	Amapá
Ferreira Gomes	Amapá
Itaubal	Amapá
Laranjal do Jari	Amapá
Macapá	Amapá
Mazagão	Amapá
Oiapoque	Amapá
Pedra Branca do Amapari	Amapá
Porto Grande	Amapá
Pracuúba	Amapá
Santana	Amapá
Serra do Navio	Amapá
Tartarugalzinho	Amapá
Vitória do Jari	Amapá
Abreulândia	Tocantins
Aguiarnópolis	Tocantins
Aliança do Tocantins	Tocantins
Almas	Tocantins
Alvorada	Tocantins
Ananás	Tocantins
Angico	Tocantins
Aparecida do Rio Negro	Tocantins
Aragominas	Tocantins
Araguacema	Tocantins
Araguaçu	Tocantins
Araguaína	Tocantins
Araguanã	Tocantins
Araguatins	Tocantins
Arapoema	Tocantins
Arraias	Tocantins
Augustinópolis	Tocantins
Aurora do Tocantins	Tocantins
Axixá do Tocantins	Tocantins
Babaçulândia	Tocantins
Bandeirantes do Tocantins	Tocantins
Barra do Ouro	Tocantins
Barrolândia	Tocantins
Bernardo Sayão	Tocantins
Bom Jesus do Tocantins	Tocantins
Brasilândia do Tocantins	Tocantins
Brejinho de Nazaré	Tocantins
Buriti do Tocantins	Tocantins
Cachoeirinha	Tocantins
Campos Lindos	Tocantins
Cariri do Tocantins	Tocantins
Carmolândia	Tocantins
Carrasco Bonito	Tocantins
Caseara	Tocantins
Centenário	Tocantins
Chapada da Natividade	Tocantins
Chapada de Areia	Tocantins
Colinas do Tocantins	Tocantins
Colméia	Tocantins
Combinado	Tocantins
Conceição do Tocantins	Tocantins
Couto Magalhães	Tocantins
Cristalândia	Tocantins
Crixás do Tocantins	Tocantins
Darcinópolis	Tocantins
Dianópolis	Tocantins
Divinópolis do Tocantins	Tocantins
Dois Irmãos do Tocantins	Tocantins
Dueré	Tocantins
Esperantina	Tocantins
Fátima	Tocantins
Figueirópolis	Tocantins
Filadélfia	Tocantins
Formoso do Araguaia	Tocantins
Fortaleza do Tabocão	Tocantins
Goianorte	Tocantins
Goiatins	Tocantins
Guaraí	Tocantins
Gurupi	Tocantins
Ipueiras	Tocantins
Itacajá	Tocantins
Itaguatins	Tocantins
Itapiratins	Tocantins
Itaporã do Tocantins	Tocantins
Jaú do Tocantins	Tocantins
Juarina	Tocantins
Lagoa da Confusão	Tocantins
Lagoa do Tocantins	Tocantins
Lajeado	Tocantins
Lavandeira	Tocantins
Lizarda	Tocantins
Luzinópolis	Tocantins
Marianópolis do Tocantins	Tocantins
Mateiros	Tocantins
Maurilândia do Tocantins	Tocantins
Miracema do Tocantins	Tocantins
Miranorte	Tocantins
Monte do Carmo	Tocantins
Monte Santo do Tocantins	Tocantins
Muricilândia	Tocantins
Natividade	Tocantins
Nazaré	Tocantins
Nova Olinda	Tocantins
Nova Rosalândia	Tocantins
Novo Acordo	Tocantins
Novo Alegre	Tocantins
Novo Jardim	Tocantins
Oliveira de Fátima	Tocantins
Palmas	Tocantins
Palmeirante	Tocantins
Palmeiras do Tocantins	Tocantins
Palmeirópolis	Tocantins
Paraíso do Tocantins	Tocantins
Paranã	Tocantins
Pau D'Arco	Tocantins
Pedro Afonso	Tocantins
Peixe	Tocantins
Pequizeiro	Tocantins
Pindorama do Tocantins	Tocantins
Piraquê	Tocantins
Pium	Tocantins
Ponte Alta do Bom Jesus	Tocantins
Ponte Alta do Tocantins	Tocantins
Porto Alegre do Tocantins	Tocantins
Porto Nacional	Tocantins
Praia Norte	Tocantins
Presidente Kennedy	Tocantins
Pugmil	Tocantins
Recursolândia	Tocantins
Riachinho	Tocantins
Rio da Conceição	Tocantins
Rio dos Bois	Tocantins
Rio Sono	Tocantins
Sampaio	Tocantins
Sandolândia	Tocantins
Santa Fé do Araguaia	Tocantins
Santa Maria do Tocantins	Tocantins
Santa Rita do Tocantins	Tocantins
Santa Rosa do Tocantins	Tocantins
Santa Tereza do Tocantins	Tocantins
Santa Terezinha do Tocantins	Tocantins
São Bento do Tocantins	Tocantins
São Félix do Tocantins	Tocantins
São Miguel do Tocantins	Tocantins
São Salvador do Tocantins	Tocantins
São Sebastião do Tocantins	Tocantins
São Valério	Tocantins
Silvanópolis	Tocantins
Sítio Novo do Tocantins	Tocantins
Sucupira	Tocantins
Taguatinga	Tocantins
Taipas do Tocantins	Tocantins
Talismã	Tocantins
Tocantínia	Tocantins
Tocantinópolis	Tocantins
Tupirama	Tocantins
Tupiratins	Tocantins
Wanderlândia	Tocantins
Xambioá	Tocantins
Açailândia	Maranhão
Afonso Cunha	Maranhão
Água Doce do Maranhão	Maranhão
Alcântara	Maranhão
Aldeias Altas	Maranhão
Altamira do Maranhão	Maranhão
Alto Alegre do Maranhão	Maranhão
Alto Alegre do Pindaré	Maranhão
Alto Parnaíba	Maranhão
Amapá do Maranhão	Maranhão
Amarante do Maranhão	Maranhão
Anajatuba	Maranhão
Anapurus	Maranhão
Apicum-Açu	Maranhão
Araguanã	Maranhão
Araioses	Maranhão
Arame	Maranhão
Arari	Maranhão
Axixá	Maranhão
Bacabal	Maranhão
Bacabeira	Maranhão
Bacuri	Maranhão
Bacurituba	Maranhão
Balsas	Maranhão
Barão de Grajaú	Maranhão
Barra do Corda	Maranhão
Barreirinhas	Maranhão
Bela Vista do Maranhão	Maranhão
Belágua	Maranhão
Benedito Leite	Maranhão
Bequimão	Maranhão
Bernardo do Mearim	Maranhão
Boa Vista do Gurupi	Maranhão
Bom Jardim	Maranhão
Bom Jesus das Selvas	Maranhão
Bom Lugar	Maranhão
Brejo	Maranhão
Brejo de Areia	Maranhão
Buriti	Maranhão
Buriti Bravo	Maranhão
Buriticupu	Maranhão
Buritirana	Maranhão
Cachoeira Grande	Maranhão
Cajapió	Maranhão
Cajari	Maranhão
Campestre do Maranhão	Maranhão
Cândido Mendes	Maranhão
Cantanhede	Maranhão
Capinzal do Norte	Maranhão
Carolina	Maranhão
Carutapera	Maranhão
Caxias	Maranhão
Cedral	Maranhão
Central do Maranhão	Maranhão
Centro do Guilherme	Maranhão
Centro Novo do Maranhão	Maranhão
Chapadinha	Maranhão
Cidelândia	Maranhão
Codó	Maranhão
Coelho Neto	Maranhão
Colinas	Maranhão
Conceição do Lago-Açu	Maranhão
Coroatá	Maranhão
Cururupu	Maranhão
Davinópolis	Maranhão
Dom Pedro	Maranhão
Duque Bacelar	Maranhão
Esperantinópolis	Maranhão
Estreito	Maranhão
Feira Nova do Maranhão	Maranhão
Fernando Falcão	Maranhão
Formosa da Serra Negra	Maranhão
Fortaleza dos Nogueiras	Maranhão
Fortuna	Maranhão
Godofredo Viana	Maranhão
Gonçalves Dias	Maranhão
Governador Archer	Maranhão
Governador Edison Lobão	Maranhão
Governador Eugênio Barros	Maranhão
Governador Luiz Rocha	Maranhão
Governador Newton Bello	Maranhão
Governador Nunes Freire	Maranhão
Graça Aranha	Maranhão
Grajaú	Maranhão
Guimarães	Maranhão
Humberto de Campos	Maranhão
Icatu	Maranhão
Igarapé do Meio	Maranhão
Igarapé Grande	Maranhão
Imperatriz	Maranhão
Itaipava do Grajaú	Maranhão
Itapecuru Mirim	Maranhão
Itinga do Maranhão	Maranhão
Jatobá	Maranhão
Jenipapo dos Vieiras	Maranhão
João Lisboa	Maranhão
Joselândia	Maranhão
Junco do Maranhão	Maranhão
Lago da Pedra	Maranhão
Lago do Junco	Maranhão
Lago dos Rodrigues	Maranhão
Lago Verde	Maranhão
Lagoa do Mato	Maranhão
Lagoa Grande do Maranhão	Maranhão
Lajeado Novo	Maranhão
Lima Campos	Maranhão
Loreto	Maranhão
Luís Domingues	Maranhão
Magalhães de Almeida	Maranhão
Maracaçumé	Maranhão
Marajá do Sena	Maranhão
Maranhãozinho	Maranhão
Mata Roma	Maranhão
Matinha	Maranhão
Matões	Maranhão
Matões do Norte	Maranhão
Milagres do Maranhão	Maranhão
Mirador	Maranhão
Miranda do Norte	Maranhão
Mirinzal	Maranhão
Monção	Maranhão
Montes Altos	Maranhão
Morros	Maranhão
Nina Rodrigues	Maranhão
Nova Colinas	Maranhão
Nova Iorque	Maranhão
Nova Olinda do Maranhão	Maranhão
Olho d'Água das Cunhãs	Maranhão
Olinda Nova do Maranhão	Maranhão
Paço do Lumiar	Maranhão
Palmeirândia	Maranhão
Paraibano	Maranhão
Parnarama	Maranhão
Passagem Franca	Maranhão
Pastos Bons	Maranhão
Paulino Neves	Maranhão
Paulo Ramos	Maranhão
Pedreiras	Maranhão
Pedro do Rosário	Maranhão
Penalva	Maranhão
Peri Mirim	Maranhão
Peritoró	Maranhão
Pindaré-Mirim	Maranhão
Pinheiro	Maranhão
Pio XII	Maranhão
Pirapemas	Maranhão
Poção de Pedras	Maranhão
Porto Franco	Maranhão
Porto Rico do Maranhão	Maranhão
Presidente Dutra	Maranhão
Presidente Juscelino	Maranhão
Presidente Médici	Maranhão
Presidente Sarney	Maranhão
Presidente Vargas	Maranhão
Primeira Cruz	Maranhão
Raposa	Maranhão
Riachão	Maranhão
Ribamar Fiquene	Maranhão
Rosário	Maranhão
Sambaíba	Maranhão
Santa Filomena do Maranhão	Maranhão
Santa Helena	Maranhão
Santa Inês	Maranhão
Santa Luzia	Maranhão
Santa Luzia do Paruá	Maranhão
Santa Quitéria do Maranhão	Maranhão
Santa Rita	Maranhão
Santana do Maranhão	Maranhão
Santo Amaro do Maranhão	Maranhão
Santo Antônio dos Lopes	Maranhão
São Benedito do Rio Preto	Maranhão
São Bento	Maranhão
São Bernardo	Maranhão
São Domingos do Azeitão	Maranhão
São Domingos do Maranhão	Maranhão
São Félix de Balsas	Maranhão
São Francisco do Brejão	Maranhão
São Francisco do Maranhão	Maranhão
São João Batista	Maranhão
São João do Carú	Maranhão
São João do Paraíso	Maranhão
São João do Soter	Maranhão
São João dos Patos	Maranhão
São José de Ribamar	Maranhão
São José dos Basílios	Maranhão
São Luís	Maranhão
São Luís Gonzaga do Maranhão	Maranhão
São Mateus do Maranhão	Maranhão
São Pedro da Água Branca	Maranhão
São Pedro dos Crentes	Maranhão
São Raimundo das Mangabeiras	Maranhão
São Raimundo do Doca Bezerra	Maranhão
São Roberto	Maranhão
São Vicente Ferrer	Maranhão
Satubinha	Maranhão
Senador Alexandre Costa	Maranhão
Senador La Rocque	Maranhão
Serrano do Maranhão	Maranhão
Sítio Novo	Maranhão
Sucupira do Norte	Maranhão
Sucupira do Riachão	Maranhão
Tasso Fragoso	Maranhão
Timbiras	Maranhão
Timon	Maranhão
Trizidela do Vale	Maranhão
Tufilândia	Maranhão
Tuntum	Maranhão
Turiaçu	Maranhão
Turilândia	Maranhão
Tutóia	Maranhão
Urbano Santos	Maranhão
Vargem Grande	Maranhão
Viana	Maranhão
Vila Nova dos Martírios	Maranhão
Vitória do Mearim	Maranhão
Vitorino Freire	Maranhão
Zé Doca	Maranhão
Acauã	Piauí
Agricolândia	Piauí
Água Branca	Piauí
Alagoinha do Piauí	Piauí
Alegrete do Piauí	Piauí
Alto Longá	Piauí
Altos	Piauí
Alvorada do Gurguéia	Piauí
Amarante	Piauí
Angical do Piauí	Piauí
Anísio de Abreu	Piauí
Antônio Almeida	Piauí
Aroazes	Piauí
Aroeiras do Itaim	Piauí
Arraial	Piauí
Assunção do Piauí	Piauí
Avelino Lopes	Piauí
Baixa Grande do Ribeiro	Piauí
Barra D'Alcântara	Piauí
Barras	Piauí
Barreiras do Piauí	Piauí
Barro Duro	Piauí
Batalha	Piauí
Bela Vista do Piauí	Piauí
Belém do Piauí	Piauí
Beneditinos	Piauí
Bertolínia	Piauí
Betânia do Piauí	Piauí
Boa Hora	Piauí
Bocaina	Piauí
Bom Jesus	Piauí
Bom Princípio do Piauí	Piauí
Bonfim do Piauí	Piauí
Boqueirão do Piauí	Piauí
Brasileira	Piauí
Brejo do Piauí	Piauí
Buriti dos Lopes	Piauí
Buriti dos Montes	Piauí
Cabeceiras do Piauí	Piauí
Cajazeiras do Piauí	Piauí
Cajueiro da Praia	Piauí
Caldeirão Grande do Piauí	Piauí
Campinas do Piauí	Piauí
Campo Alegre do Fidalgo	Piauí
Campo Grande do Piauí	Piauí
Campo Largo do Piauí	Piauí
Campo Maior	Piauí
Canavieira	Piauí
Canto do Buriti	Piauí
Capitão de Campos	Piauí
Capitão Gervásio Oliveira	Piauí
Caracol	Piauí
Caraúbas do Piauí	Piauí
Caridade do Piauí	Piauí
Castelo do Piauí	Piauí
Caxingó	Piauí
Cocal	Piauí
Cocal de Telha	Piauí
Cocal dos Alves	Piauí
Coivaras	Piauí
Colônia do Gurguéia	Piauí
Colônia do Piauí	Piauí
Conceição do Canindé	Piauí
Coronel José Dias	Piauí
Corrente	Piauí
Cristalândia do Piauí	Piauí
Cristino Castro	Piauí
Curimatá	Piauí
Currais	Piauí
Curral Novo do Piauí	Piauí
Curralinhos	Piauí
Demerval Lobão	Piauí
Dirceu Arcoverde	Piauí
Dom Expedito Lopes	Piauí
Dom Inocêncio	Piauí
Domingos Mourão	Piauí
Elesbão Veloso	Piauí
Eliseu Martins	Piauí
Esperantina	Piauí
Fartura do Piauí	Piauí
Flores do Piauí	Piauí
Floresta do Piauí	Piauí
Floriano	Piauí
Francinópolis	Piauí
Francisco Ayres	Piauí
Francisco Macedo	Piauí
Francisco Santos	Piauí
Fronteiras	Piauí
Geminiano	Piauí
Gilbués	Piauí
Guadalupe	Piauí
Guaribas	Piauí
Hugo Napoleão	Piauí
Ilha Grande	Piauí
Inhuma	Piauí
Ipiranga do Piauí	Piauí
Isaías Coelho	Piauí
Itainópolis	Piauí
Itaueira	Piauí
Jacobina do Piauí	Piauí
Jaicós	Piauí
Jardim do Mulato	Piauí
Jatobá do Piauí	Piauí
Jerumenha	Piauí
João Costa	Piauí
Joaquim Pires	Piauí
Joca Marques	Piauí
José de Freitas	Piauí
Juazeiro do Piauí	Piauí
Júlio Borges	Piauí
Jurema	Piauí
Lagoa Alegre	Piauí
Lagoa de São Francisco	Piauí
Lagoa do Barro do Piauí	Piauí
Lagoa do Piauí	Piauí
Lagoa do Sítio	Piauí
Lagoinha do Piauí	Piauí
Landri Sales	Piauí
Luís Correia	Piauí
Luzilândia	Piauí
Madeiro	Piauí
Manoel Emídio	Piauí
Marcolândia	Piauí
Marcos Parente	Piauí
Massapê do Piauí	Piauí
Matias Olímpio	Piauí
Miguel Alves	Piauí
Miguel Leão	Piauí
Milton Brandão	Piauí
Monsenhor Gil	Piauí
Monsenhor Hipólito	Piauí
Monte Alegre do Piauí	Piauí
Morro Cabeça no Tempo	Piauí
Morro do Chapéu do Piauí	Piauí
Murici dos Portelas	Piauí
Nazaré do Piauí	Piauí
Nazária	Piauí
Nossa Senhora de Nazaré	Piauí
Nossa Senhora dos Remédios	Piauí
Nova Santa Rita	Piauí
Novo Oriente do Piauí	Piauí
Novo Santo Antônio	Piauí
Oeiras	Piauí
Olho D'Água do Piauí	Piauí
Padre Marcos	Piauí
Paes Landim	Piauí
Pajeú do Piauí	Piauí
Palmeira do Piauí	Piauí
Palmeirais	Piauí
Paquetá	Piauí
Parnaguá	Piauí
Parnaíba	Piauí
Passagem Franca do Piauí	Piauí
Patos do Piauí	Piauí
Pau D'Arco do Piauí	Piauí
Paulistana	Piauí
Pavussu	Piauí
Pedro II	Piauí
Pedro Laurentino	Piauí
Picos	Piauí
Pimenteiras	Piauí
Pio IX	Piauí
Piracuruca	Piauí
Piripiri	Piauí
Porto	Piauí
Porto Alegre do Piauí	Piauí
Prata do Piauí	Piauí
Queimada Nova	Piauí
Redenção do Gurguéia	Piauí
Regeneração	Piauí
Riacho Frio	Piauí
Ribeira do Piauí	Piauí
Ribeiro Gonçalves	Piauí
Rio Grande do Piauí	Piauí
Santa Cruz do Piauí	Piauí
Santa Cruz dos Milagres	Piauí
Santa Filomena	Piauí
Santa Luz	Piauí
Santa Rosa do Piauí	Piauí
Santana do Piauí	Piauí
Santo Antônio de Lisboa	Piauí
Santo Antônio dos Milagres	Piauí
Santo Inácio do Piauí	Piauí
São Braz do Piauí	Piauí
São Félix do Piauí	Piauí
São Francisco de Assis do Piauí	Piauí
São Francisco do Piauí	Piauí
São Gonçalo do Gurguéia	Piauí
São Gonçalo do Piauí	Piauí
São João da Canabrava	Piauí
São João da Fronteira	Piauí
São João da Serra	Piauí
São João da Varjota	Piauí
São João do Arraial	Piauí
São João do Piauí	Piauí
São José do Divino	Piauí
São José do Peixe	Piauí
São José do Piauí	Piauí
São Julião	Piauí
São Lourenço do Piauí	Piauí
São Luis do Piauí	Piauí
São Miguel da Baixa Grande	Piauí
São Miguel do Fidalgo	Piauí
São Miguel do Tapuio	Piauí
São Pedro do Piauí	Piauí
São Raimundo Nonato	Piauí
Sebastião Barros	Piauí
Sebastião Leal	Piauí
Sigefredo Pacheco	Piauí
Simões	Piauí
Simplício Mendes	Piauí
Socorro do Piauí	Piauí
Sussuapara	Piauí
Tamboril do Piauí	Piauí
Tanque do Piauí	Piauí
Teresina	Piauí
União	Piauí
Uruçuí	Piauí
Valença do Piauí	Piauí
Várzea Branca	Piauí
Várzea Grande	Piauí
Vera Mendes	Piauí
Vila Nova do Piauí	Piauí
Wall Ferraz	Piauí
Abaiara	Ceará
Acarape	Ceará
Acaraú	Ceará
Acopiara	Ceará
Aiuaba	Ceará
Alcântaras	Ceará
Altaneira	Ceará
Alto Santo	Ceará
Amontada	Ceará
Antonina do Norte	Ceará
Apuiarés	Ceará
Aquiraz	Ceará
Aracati	Ceará
Aracoiaba	Ceará
Ararendá	Ceará
Araripe	Ceará
Aratuba	Ceará
Arneiroz	Ceará
Assaré	Ceará
Aurora	Ceará
Baixio	Ceará
Banabuiú	Ceará
Barbalha	Ceará
Barreira	Ceará
Barro	Ceará
Barroquinha	Ceará
Baturité	Ceará
Beberibe	Ceará
Bela Cruz	Ceará
Boa Viagem	Ceará
Brejo Santo	Ceará
Camocim	Ceará
Campos Sales	Ceará
Canindé	Ceará
Capistrano	Ceará
Caridade	Ceará
Cariré	Ceará
Caririaçu	Ceará
Cariús	Ceará
Carnaubal	Ceará
Cascavel	Ceará
Catarina	Ceará
Catunda	Ceará
Caucaia	Ceará
Cedro	Ceará
Chaval	Ceará
Choró	Ceará
Chorozinho	Ceará
Coreaú	Ceará
Crateús	Ceará
Crato	Ceará
Croatá	Ceará
Cruz	Ceará
Deputado Irapuan Pinheiro	Ceará
Ererê	Ceará
Eusébio	Ceará
Farias Brito	Ceará
Forquilha	Ceará
Fortaleza	Ceará
Fortim	Ceará
Frecheirinha	Ceará
General Sampaio	Ceará
Graça	Ceará
Granja	Ceará
Granjeiro	Ceará
Groaíras	Ceará
Guaiúba	Ceará
Guaraciaba do Norte	Ceará
Guaramiranga	Ceará
Hidrolândia	Ceará
Horizonte	Ceará
Ibaretama	Ceará
Ibiapina	Ceará
Ibicuitinga	Ceará
Icapuí	Ceará
Icó	Ceará
Iguatu	Ceará
Independência	Ceará
Ipaporanga	Ceará
Ipaumirim	Ceará
Ipu	Ceará
Ipueiras	Ceará
Iracema	Ceará
Irauçuba	Ceará
Itaiçaba	Ceará
Itaitinga	Ceará
Itapajé	Ceará
Itapipoca	Ceará
Itapiúna	Ceará
Itarema	Ceará
Itatira	Ceará
Jaguaretama	Ceará
Jaguaribara	Ceará
Jaguaribe	Ceará
Jaguaruana	Ceará
Jardim	Ceará
Jati	Ceará
Jijoca de Jericoacoara	Ceará
Juazeiro do Norte	Ceará
Jucás	Ceará
Lavras da Mangabeira	Ceará
Limoeiro do Norte	Ceará
Madalena	Ceará
Maracanaú	Ceará
Maranguape	Ceará
Marco	Ceará
Martinópole	Ceará
Massapê	Ceará
Mauriti	Ceará
Meruoca	Ceará
Milagres	Ceará
Milhã	Ceará
Miraíma	Ceará
Missão Velha	Ceará
Mombaça	Ceará
Monsenhor Tabosa	Ceará
Morada Nova	Ceará
Moraújo	Ceará
Morrinhos	Ceará
Mucambo	Ceará
Mulungu	Ceará
Nova Olinda	Ceará
Nova Russas	Ceará
Novo Oriente	Ceará
Ocara	Ceará
Orós	Ceará
Pacajus	Ceará
Pacatuba	Ceará
Pacoti	Ceará
Pacujá	Ceará
Palhano	Ceará
Palmácia	Ceará
Paracuru	Ceará
Paraipaba	Ceará
Parambu	Ceará
Paramoti	Ceará
Pedra Branca	Ceará
Penaforte	Ceará
Pentecoste	Ceará
Pereiro	Ceará
Pindoretama	Ceará
Piquet Carneiro	Ceará
Pires Ferreira	Ceará
Poranga	Ceará
Porteiras	Ceará
Potengi	Ceará
Potiretama	Ceará
Quiterianópolis	Ceará
Quixadá	Ceará
Quixelô	Ceará
Quixeramobim	Ceará
Quixeré	Ceará
Redenção	Ceará
Reriutaba	Ceará
Russas	Ceará
Saboeiro	Ceará
Salitre	Ceará
Santa Quitéria	Ceará
Santana do Acaraú	Ceará
Santana do Cariri	Ceará
São Benedito	Ceará
São Gonçalo do Amarante	Ceará
São João do Jaguaribe	Ceará
São Luís do Curu	Ceará
Senador Pompeu	Ceará
Senador Sá	Ceará
Sobral	Ceará
Solonópole	Ceará
Tabuleiro do Norte	Ceará
Tamboril	Ceará
Tarrafas	Ceará
Tauá	Ceará
Tejuçuoca	Ceará
Tianguá	Ceará
Trairi	Ceará
Tururu	Ceará
Ubajara	Ceará
Umari	Ceará
Umirim	Ceará
Uruburetama	Ceará
Uruoca	Ceará
Varjota	Ceará
Várzea Alegre	Ceará
Viçosa do Ceará	Ceará
Acari	Rio Grande do Norte
Açu	Rio Grande do Norte
Afonso Bezerra	Rio Grande do Norte
Água Nova	Rio Grande do Norte
Alexandria	Rio Grande do Norte
Almino Afonso	Rio Grande do Norte
Alto do Rodrigues	Rio Grande do Norte
Angicos	Rio Grande do Norte
Antônio Martins	Rio Grande do Norte
Apodi	Rio Grande do Norte
Areia Branca	Rio Grande do Norte
Arês	Rio Grande do Norte
Augusto Severo	Rio Grande do Norte
Baía Formosa	Rio Grande do Norte
Baraúna	Rio Grande do Norte
Barcelona	Rio Grande do Norte
Bento Fernandes	Rio Grande do Norte
Bodó	Rio Grande do Norte
Bom Jesus	Rio Grande do Norte
Brejinho	Rio Grande do Norte
Caiçara do Norte	Rio Grande do Norte
Caiçara do Rio do Vento	Rio Grande do Norte
Caicó	Rio Grande do Norte
Campo Redondo	Rio Grande do Norte
Canguaretama	Rio Grande do Norte
Caraúbas	Rio Grande do Norte
Carnaúba dos Dantas	Rio Grande do Norte
Carnaubais	Rio Grande do Norte
Ceará-Mirim	Rio Grande do Norte
Cerro Corá	Rio Grande do Norte
Coronel Ezequiel	Rio Grande do Norte
Coronel João Pessoa	Rio Grande do Norte
Cruzeta	Rio Grande do Norte
Currais Novos	Rio Grande do Norte
Doutor Severiano	Rio Grande do Norte
Encanto	Rio Grande do Norte
Equador	Rio Grande do Norte
Espírito Santo	Rio Grande do Norte
Extremoz	Rio Grande do Norte
Felipe Guerra	Rio Grande do Norte
Fernando Pedroza	Rio Grande do Norte
Florânia	Rio Grande do Norte
Francisco Dantas	Rio Grande do Norte
Frutuoso Gomes	Rio Grande do Norte
Galinhos	Rio Grande do Norte
Goianinha	Rio Grande do Norte
Governador Dix-Sept Rosado	Rio Grande do Norte
Grossos	Rio Grande do Norte
Guamaré	Rio Grande do Norte
Ielmo Marinho	Rio Grande do Norte
Ipanguaçu	Rio Grande do Norte
Ipueira	Rio Grande do Norte
Itajá	Rio Grande do Norte
Itaú	Rio Grande do Norte
Jaçanã	Rio Grande do Norte
Jandaíra	Rio Grande do Norte
Janduís	Rio Grande do Norte
Januário Cicco	Rio Grande do Norte
Japi	Rio Grande do Norte
Jardim de Angicos	Rio Grande do Norte
Jardim de Piranhas	Rio Grande do Norte
Jardim do Seridó	Rio Grande do Norte
João Câmara	Rio Grande do Norte
João Dias	Rio Grande do Norte
José da Penha	Rio Grande do Norte
Jucurutu	Rio Grande do Norte
Jundiá	Rio Grande do Norte
Lagoa d'Anta	Rio Grande do Norte
Lagoa de Pedras	Rio Grande do Norte
Lagoa de Velhos	Rio Grande do Norte
Lagoa Nova	Rio Grande do Norte
Lagoa Salgada	Rio Grande do Norte
Lajes	Rio Grande do Norte
Lajes Pintadas	Rio Grande do Norte
Lucrécia	Rio Grande do Norte
Luís Gomes	Rio Grande do Norte
Macaíba	Rio Grande do Norte
Macau	Rio Grande do Norte
Major Sales	Rio Grande do Norte
Marcelino Vieira	Rio Grande do Norte
Martins	Rio Grande do Norte
Maxaranguape	Rio Grande do Norte
Messias Targino	Rio Grande do Norte
Montanhas	Rio Grande do Norte
Monte Alegre	Rio Grande do Norte
Monte das Gameleiras	Rio Grande do Norte
Mossoró	Rio Grande do Norte
Natal	Rio Grande do Norte
Nísia Floresta	Rio Grande do Norte
Nova Cruz	Rio Grande do Norte
Olho d'Água do Borges	Rio Grande do Norte
Ouro Branco	Rio Grande do Norte
Paraná	Rio Grande do Norte
Paraú	Rio Grande do Norte
Parazinho	Rio Grande do Norte
Parelhas	Rio Grande do Norte
Parnamirim	Rio Grande do Norte
Passa e Fica	Rio Grande do Norte
Passagem	Rio Grande do Norte
Patu	Rio Grande do Norte
Pau dos Ferros	Rio Grande do Norte
Pedra Grande	Rio Grande do Norte
Pedra Preta	Rio Grande do Norte
Pedro Avelino	Rio Grande do Norte
Pedro Velho	Rio Grande do Norte
Pendências	Rio Grande do Norte
Pilões	Rio Grande do Norte
Poço Branco	Rio Grande do Norte
Portalegre	Rio Grande do Norte
Porto do Mangue	Rio Grande do Norte
Pureza	Rio Grande do Norte
Rafael Fernandes	Rio Grande do Norte
Rafael Godeiro	Rio Grande do Norte
Riacho da Cruz	Rio Grande do Norte
Riacho de Santana	Rio Grande do Norte
Riachuelo	Rio Grande do Norte
Rio do Fogo	Rio Grande do Norte
Rodolfo Fernandes	Rio Grande do Norte
Ruy Barbosa	Rio Grande do Norte
Santa Cruz	Rio Grande do Norte
Santa Maria	Rio Grande do Norte
Santana do Matos	Rio Grande do Norte
Santana do Seridó	Rio Grande do Norte
Santo Antônio	Rio Grande do Norte
São Bento do Norte	Rio Grande do Norte
São Bento do Trairí	Rio Grande do Norte
São Fernando	Rio Grande do Norte
São Francisco do Oeste	Rio Grande do Norte
São Gonçalo do Amarante	Rio Grande do Norte
São João do Sabugi	Rio Grande do Norte
São José de Mipibu	Rio Grande do Norte
São José do Campestre	Rio Grande do Norte
São José do Seridó	Rio Grande do Norte
São Miguel	Rio Grande do Norte
São Miguel do Gostoso	Rio Grande do Norte
São Paulo do Potengi	Rio Grande do Norte
São Pedro	Rio Grande do Norte
São Rafael	Rio Grande do Norte
São Tomé	Rio Grande do Norte
São Vicente	Rio Grande do Norte
Senador Elói de Souza	Rio Grande do Norte
Senador Georgino Avelino	Rio Grande do Norte
Serra Caiada	Rio Grande do Norte
Serra de São Bento	Rio Grande do Norte
Serra do Mel	Rio Grande do Norte
Serra Negra do Norte	Rio Grande do Norte
Serrinha	Rio Grande do Norte
Serrinha dos Pintos	Rio Grande do Norte
Severiano Melo	Rio Grande do Norte
Sítio Novo	Rio Grande do Norte
Taboleiro Grande	Rio Grande do Norte
Taipu	Rio Grande do Norte
Tangará	Rio Grande do Norte
Tenente Ananias	Rio Grande do Norte
Tenente Laurentino Cruz	Rio Grande do Norte
Tibau	Rio Grande do Norte
Tibau do Sul	Rio Grande do Norte
Timbaúba dos Batistas	Rio Grande do Norte
Touros	Rio Grande do Norte
Triunfo Potiguar	Rio Grande do Norte
Umarizal	Rio Grande do Norte
Upanema	Rio Grande do Norte
Várzea	Rio Grande do Norte
Venha-Ver	Rio Grande do Norte
Vera Cruz	Rio Grande do Norte
Viçosa	Rio Grande do Norte
Vila Flor	Rio Grande do Norte
Água Branca	Paraíba
Aguiar	Paraíba
Alagoa Grande	Paraíba
Alagoa Nova	Paraíba
Alagoinha	Paraíba
Alcantil	Paraíba
Algodão de Jandaíra	Paraíba
Alhandra	Paraíba
Amparo	Paraíba
Aparecida	Paraíba
Araçagi	Paraíba
Arara	Paraíba
Araruna	Paraíba
Areia	Paraíba
Areia de Baraúnas	Paraíba
Areial	Paraíba
Aroeiras	Paraíba
Assunção	Paraíba
Baía da Traição	Paraíba
Bananeiras	Paraíba
Baraúna	Paraíba
Barra de Santa Rosa	Paraíba
Barra de Santana	Paraíba
Barra de São Miguel	Paraíba
Bayeux	Paraíba
Belém	Paraíba
Belém do Brejo do Cruz	Paraíba
Bernardino Batista	Paraíba
Boa Ventura	Paraíba
Boa Vista	Paraíba
Bom Jesus	Paraíba
Bom Sucesso	Paraíba
Bonito de Santa Fé	Paraíba
Boqueirão	Paraíba
Borborema	Paraíba
Brejo do Cruz	Paraíba
Brejo dos Santos	Paraíba
Caaporã	Paraíba
Cabaceiras	Paraíba
Cabedelo	Paraíba
Cachoeira dos Índios	Paraíba
Cacimba de Areia	Paraíba
Cacimba de Dentro	Paraíba
Cacimbas	Paraíba
Caiçara	Paraíba
Cajazeiras	Paraíba
Cajazeirinhas	Paraíba
Caldas Brandão	Paraíba
Camalaú	Paraíba
Campina Grande	Paraíba
Capim	Paraíba
Caraúbas	Paraíba
Carrapateira	Paraíba
Casserengue	Paraíba
Catingueira	Paraíba
Catolé do Rocha	Paraíba
Caturité	Paraíba
Conceição	Paraíba
Condado	Paraíba
Conde	Paraíba
Congo	Paraíba
Coremas	Paraíba
Coxixola	Paraíba
Cruz do Espírito Santo	Paraíba
Cubati	Paraíba
Cuité	Paraíba
Cuité de Mamanguape	Paraíba
Cuitegi	Paraíba
Curral de Cima	Paraíba
Curral Velho	Paraíba
Damião	Paraíba
Desterro	Paraíba
Diamante	Paraíba
Dona Inês	Paraíba
Duas Estradas	Paraíba
Emas	Paraíba
Esperança	Paraíba
Fagundes	Paraíba
Frei Martinho	Paraíba
Gado Bravo	Paraíba
Guarabira	Paraíba
Gurinhém	Paraíba
Gurjão	Paraíba
Ibiara	Paraíba
Igaracy	Paraíba
Imaculada	Paraíba
Ingá	Paraíba
Itabaiana	Paraíba
Itaporanga	Paraíba
Itapororoca	Paraíba
Itatuba	Paraíba
Jacaraú	Paraíba
Jericó	Paraíba
João Pessoa	Paraíba
Joca Claudino	Paraíba
Juarez Távora	Paraíba
Juazeirinho	Paraíba
Junco do Seridó	Paraíba
Juripiranga	Paraíba
Juru	Paraíba
Lagoa	Paraíba
Lagoa de Dentro	Paraíba
Lagoa Seca	Paraíba
Lastro	Paraíba
Livramento	Paraíba
Logradouro	Paraíba
Lucena	Paraíba
Mãe d'Água	Paraíba
Malta	Paraíba
Mamanguape	Paraíba
Manaíra	Paraíba
Marcação	Paraíba
Mari	Paraíba
Marizópolis	Paraíba
Massaranduba	Paraíba
Mataraca	Paraíba
Matinhas	Paraíba
Mato Grosso	Paraíba
Maturéia	Paraíba
Mogeiro	Paraíba
Montadas	Paraíba
Monte Horebe	Paraíba
Monteiro	Paraíba
Mulungu	Paraíba
Natuba	Paraíba
Nazarezinho	Paraíba
Nova Floresta	Paraíba
Nova Olinda	Paraíba
Nova Palmeira	Paraíba
Olho d'Água	Paraíba
Olivedos	Paraíba
Ouro Velho	Paraíba
Parari	Paraíba
Passagem	Paraíba
Patos	Paraíba
Paulista	Paraíba
Pedra Branca	Paraíba
Pedra Lavrada	Paraíba
Pedras de Fogo	Paraíba
Pedro Régis	Paraíba
Piancó	Paraíba
Picuí	Paraíba
Pilar	Paraíba
Pilões	Paraíba
Pilõezinhos	Paraíba
Pirpirituba	Paraíba
Pitimbu	Paraíba
Pocinhos	Paraíba
Poço Dantas	Paraíba
Poço de José de Moura	Paraíba
Pombal	Paraíba
Prata	Paraíba
Princesa Isabel	Paraíba
Puxinanã	Paraíba
Queimadas	Paraíba
Quixaba	Paraíba
Remígio	Paraíba
Riachão	Paraíba
Riachão do Bacamarte	Paraíba
Riachão do Poço	Paraíba
Riacho de Santo Antônio	Paraíba
Riacho dos Cavalos	Paraíba
Rio Tinto	Paraíba
Salgadinho	Paraíba
Salgado de São Félix	Paraíba
Santa Cecília	Paraíba
Santa Cruz	Paraíba
Santa Helena	Paraíba
Santa Inês	Paraíba
Santa Luzia	Paraíba
Santa Rita	Paraíba
Santa Teresinha	Paraíba
Santana de Mangueira	Paraíba
Santana dos Garrotes	Paraíba
Santo André	Paraíba
São Bentinho	Paraíba
São Bento	Paraíba
São Domingos	Paraíba
São Domingos do Cariri	Paraíba
São Francisco	Paraíba
São João do Cariri	Paraíba
São João do Rio do Peixe	Paraíba
São João do Tigre	Paraíba
São José da Lagoa Tapada	Paraíba
São José de Caiana	Paraíba
São José de Espinharas	Paraíba
São José de Piranhas	Paraíba
São José de Princesa	Paraíba
São José do Bonfim	Paraíba
São José do Brejo do Cruz	Paraíba
São José do Sabugi	Paraíba
São José dos Cordeiros	Paraíba
São José dos Ramos	Paraíba
São Mamede	Paraíba
São Miguel de Taipu	Paraíba
São Sebastião de Lagoa de Roça	Paraíba
São Sebastião do Umbuzeiro	Paraíba
São Vicente do Seridó	Paraíba
Sapé	Paraíba
Serra Branca	Paraíba
Serra da Raiz	Paraíba
Serra Grande	Paraíba
Serra Redonda	Paraíba
Serraria	Paraíba
Sertãozinho	Paraíba
Sobrado	Paraíba
Solânea	Paraíba
Soledade	Paraíba
Sossêgo	Paraíba
Sousa	Paraíba
Sumé	Paraíba
Tacima	Paraíba
Taperoá	Paraíba
Tavares	Paraíba
Teixeira	Paraíba
Tenório	Paraíba
Triunfo	Paraíba
Uiraúna	Paraíba
Umbuzeiro	Paraíba
Várzea	Paraíba
Vieirópolis	Paraíba
Vista Serrana	Paraíba
Zabelê	Paraíba
Abreu e Lima	Pernambuco
Afogados da Ingazeira	Pernambuco
Afrânio	Pernambuco
Agrestina	Pernambuco
Água Preta	Pernambuco
Águas Belas	Pernambuco
Alagoinha	Pernambuco
Aliança	Pernambuco
Altinho	Pernambuco
Amaraji	Pernambuco
Angelim	Pernambuco
Araçoiaba	Pernambuco
Araripina	Pernambuco
Arcoverde	Pernambuco
Barra de Guabiraba	Pernambuco
Barreiros	Pernambuco
Belém de Maria	Pernambuco
Belém do São Francisco	Pernambuco
Belo Jardim	Pernambuco
Betânia	Pernambuco
Bezerros	Pernambuco
Bodocó	Pernambuco
Bom Conselho	Pernambuco
Bom Jardim	Pernambuco
Bonito	Pernambuco
Brejão	Pernambuco
Brejinho	Pernambuco
Brejo da Madre de Deus	Pernambuco
Buenos Aires	Pernambuco
Buíque	Pernambuco
Cabo de Santo Agostinho	Pernambuco
Cabrobó	Pernambuco
Cachoeirinha	Pernambuco
Caetés	Pernambuco
Calçado	Pernambuco
Calumbi	Pernambuco
Camaragibe	Pernambuco
Camocim de São Félix	Pernambuco
Camutanga	Pernambuco
Canhotinho	Pernambuco
Capoeiras	Pernambuco
Carnaíba	Pernambuco
Carnaubeira da Penha	Pernambuco
Carpina	Pernambuco
Caruaru	Pernambuco
Casinhas	Pernambuco
Catende	Pernambuco
Cedro	Pernambuco
Chã de Alegria	Pernambuco
Chã Grande	Pernambuco
Condado	Pernambuco
Correntes	Pernambuco
Cortês	Pernambuco
Cumaru	Pernambuco
Cupira	Pernambuco
Custódia	Pernambuco
Dormentes	Pernambuco
Escada	Pernambuco
Exu	Pernambuco
Feira Nova	Pernambuco
Fernando de Noronha	Pernambuco
Ferreiros	Pernambuco
Flores	Pernambuco
Floresta	Pernambuco
Frei Miguelinho	Pernambuco
Gameleira	Pernambuco
Garanhuns	Pernambuco
Glória do Goitá	Pernambuco
Goiana	Pernambuco
Granito	Pernambuco
Gravatá	Pernambuco
Iati	Pernambuco
Ibimirim	Pernambuco
Ibirajuba	Pernambuco
Igarassu	Pernambuco
Iguaracy	Pernambuco
Ilha de Itamaracá	Pernambuco
Inajá	Pernambuco
Ingazeira	Pernambuco
Ipojuca	Pernambuco
Ipubi	Pernambuco
Itacuruba	Pernambuco
Itaíba	Pernambuco
Itambé	Pernambuco
Itapetim	Pernambuco
Itapissuma	Pernambuco
Itaquitinga	Pernambuco
Jaboatão dos Guararapes	Pernambuco
Jaqueira	Pernambuco
Jataúba	Pernambuco
Jatobá	Pernambuco
João Alfredo	Pernambuco
Joaquim Nabuco	Pernambuco
Jucati	Pernambuco
Jupi	Pernambuco
Jurema	Pernambuco
Lagoa de Itaenga	Pernambuco
Lagoa do Carro	Pernambuco
Lagoa do Ouro	Pernambuco
Lagoa dos Gatos	Pernambuco
Lagoa Grande	Pernambuco
Lajedo	Pernambuco
Limoeiro	Pernambuco
Macaparana	Pernambuco
Machados	Pernambuco
Manari	Pernambuco
Maraial	Pernambuco
Mirandiba	Pernambuco
Moreilândia	Pernambuco
Moreno	Pernambuco
Nazaré da Mata	Pernambuco
Olinda	Pernambuco
Orobó	Pernambuco
Orocó	Pernambuco
Ouricuri	Pernambuco
Palmares	Pernambuco
Palmeirina	Pernambuco
Panelas	Pernambuco
Paranatama	Pernambuco
Parnamirim	Pernambuco
Passira	Pernambuco
Paudalho	Pernambuco
Paulista	Pernambuco
Pedra	Pernambuco
Pesqueira	Pernambuco
Petrolândia	Pernambuco
Petrolina	Pernambuco
Poção	Pernambuco
Pombos	Pernambuco
Primavera	Pernambuco
Quipapá	Pernambuco
Quixaba	Pernambuco
Recife	Pernambuco
Riacho das Almas	Pernambuco
Ribeirão	Pernambuco
Rio Formoso	Pernambuco
Sairé	Pernambuco
Salgadinho	Pernambuco
Salgueiro	Pernambuco
Saloá	Pernambuco
Sanharó	Pernambuco
Santa Cruz	Pernambuco
Santa Cruz da Baixa Verde	Pernambuco
Santa Cruz do Capibaribe	Pernambuco
Santa Filomena	Pernambuco
Santa Maria da Boa Vista	Pernambuco
Santa Maria do Cambucá	Pernambuco
Santa Terezinha	Pernambuco
São Benedito do Sul	Pernambuco
São Bento do Una	Pernambuco
São Caitano	Pernambuco
São João	Pernambuco
São Joaquim do Monte	Pernambuco
São José da Coroa Grande	Pernambuco
São José do Belmonte	Pernambuco
São José do Egito	Pernambuco
São Lourenço da Mata	Pernambuco
São Vicente Férrer	Pernambuco
Serra Talhada	Pernambuco
Serrita	Pernambuco
Sertânia	Pernambuco
Sirinhaém	Pernambuco
Solidão	Pernambuco
Surubim	Pernambuco
Tabira	Pernambuco
Tacaimbó	Pernambuco
Tacaratu	Pernambuco
Tamandaré	Pernambuco
Taquaritinga do Norte	Pernambuco
Terezinha	Pernambuco
Terra Nova	Pernambuco
Timbaúba	Pernambuco
Toritama	Pernambuco
Tracunhaém	Pernambuco
Trindade	Pernambuco
Triunfo	Pernambuco
Tupanatinga	Pernambuco
Tuparetama	Pernambuco
Venturosa	Pernambuco
Verdejante	Pernambuco
Vertente do Lério	Pernambuco
Vertentes	Pernambuco
Vicência	Pernambuco
Vitória de Santo Antão	Pernambuco
Xexéu	Pernambuco
Água Branca	Alagoas
Anadia	Alagoas
Arapiraca	Alagoas
Atalaia	Alagoas
Barra de Santo Antônio	Alagoas
Barra de São Miguel	Alagoas
Batalha	Alagoas
Belém	Alagoas
Belo Monte	Alagoas
Boca da Mata	Alagoas
Branquinha	Alagoas
Cacimbinhas	Alagoas
Cajueiro	Alagoas
Campestre	Alagoas
Campo Alegre	Alagoas
Campo Grande	Alagoas
Canapi	Alagoas
Capela	Alagoas
Carneiros	Alagoas
Chã Preta	Alagoas
Coité do Nóia	Alagoas
Colônia Leopoldina	Alagoas
Coqueiro Seco	Alagoas
Coruripe	Alagoas
Craíbas	Alagoas
Delmiro Gouveia	Alagoas
Dois Riachos	Alagoas
Estrela de Alagoas	Alagoas
Feira Grande	Alagoas
Feliz Deserto	Alagoas
Flexeiras	Alagoas
Girau do Ponciano	Alagoas
Ibateguara	Alagoas
Igaci	Alagoas
Igreja Nova	Alagoas
Inhapi	Alagoas
Jacaré dos Homens	Alagoas
Jacuípe	Alagoas
Japaratinga	Alagoas
Jaramataia	Alagoas
Jequiá da Praia	Alagoas
Joaquim Gomes	Alagoas
Jundiá	Alagoas
Junqueiro	Alagoas
Lagoa da Canoa	Alagoas
Limoeiro de Anadia	Alagoas
Maceió	Alagoas
Major Isidoro	Alagoas
Mar Vermelho	Alagoas
Maragogi	Alagoas
Maravilha	Alagoas
Marechal Deodoro	Alagoas
Maribondo	Alagoas
Mata Grande	Alagoas
Matriz de Camaragibe	Alagoas
Messias	Alagoas
Minador do Negrão	Alagoas
Monteirópolis	Alagoas
Murici	Alagoas
Novo Lino	Alagoas
Olho d'Água das Flores	Alagoas
Olho d'Água do Casado	Alagoas
Olho d'Água Grande	Alagoas
Olivença	Alagoas
Ouro Branco	Alagoas
Palestina	Alagoas
Palmeira dos Índios	Alagoas
Pão de Açúcar	Alagoas
Pariconha	Alagoas
Paripueira	Alagoas
Passo de Camaragibe	Alagoas
Paulo Jacinto	Alagoas
Penedo	Alagoas
Piaçabuçu	Alagoas
Pilar	Alagoas
Pindoba	Alagoas
Piranhas	Alagoas
Poço das Trincheiras	Alagoas
Porto Calvo	Alagoas
Porto de Pedras	Alagoas
Porto Real do Colégio	Alagoas
Quebrangulo	Alagoas
Rio Largo	Alagoas
Roteiro	Alagoas
Santa Luzia do Norte	Alagoas
Santana do Ipanema	Alagoas
Santana do Mundaú	Alagoas
São Brás	Alagoas
São José da Laje	Alagoas
São José da Tapera	Alagoas
São Luís do Quitunde	Alagoas
São Miguel dos Campos	Alagoas
São Miguel dos Milagres	Alagoas
São Sebastião	Alagoas
Satuba	Alagoas
Senador Rui Palmeira	Alagoas
Tanque d'Arca	Alagoas
Taquarana	Alagoas
Teotônio Vilela	Alagoas
Traipu	Alagoas
União dos Palmares	Alagoas
Viçosa	Alagoas
Amparo de São Francisco	Sergipe
Aquidabã	Sergipe
Aracaju	Sergipe
Arauá	Sergipe
Areia Branca	Sergipe
Barra dos Coqueiros	Sergipe
Boquim	Sergipe
Brejo Grande	Sergipe
Campo do Brito	Sergipe
Canhoba	Sergipe
Canindé de São Francisco	Sergipe
Capela	Sergipe
Carira	Sergipe
Carmópolis	Sergipe
Cedro de São João	Sergipe
Cristinápolis	Sergipe
Cumbe	Sergipe
Divina Pastora	Sergipe
Estância	Sergipe
Feira Nova	Sergipe
Frei Paulo	Sergipe
Gararu	Sergipe
General Maynard	Sergipe
Gracho Cardoso	Sergipe
Ilha das Flores	Sergipe
Indiaroba	Sergipe
Itabaiana	Sergipe
Itabaianinha	Sergipe
Itabi	Sergipe
Itaporanga d'Ajuda	Sergipe
Japaratuba	Sergipe
Japoatã	Sergipe
Lagarto	Sergipe
Laranjeiras	Sergipe
Macambira	Sergipe
Malhada dos Bois	Sergipe
Malhador	Sergipe
Maruim	Sergipe
Moita Bonita	Sergipe
Monte Alegre de Sergipe	Sergipe
Muribeca	Sergipe
Neópolis	Sergipe
Nossa Senhora Aparecida	Sergipe
Nossa Senhora da Glória	Sergipe
Nossa Senhora das Dores	Sergipe
Nossa Senhora de Lourdes	Sergipe
Nossa Senhora do Socorro	Sergipe
Pacatuba	Sergipe
Pedra Mole	Sergipe
Pedrinhas	Sergipe
Pinhão	Sergipe
Pirambu	Sergipe
Poço Redondo	Sergipe
Poço Verde	Sergipe
Porto da Folha	Sergipe
Propriá	Sergipe
Riachão do Dantas	Sergipe
Riachuelo	Sergipe
Ribeirópolis	Sergipe
Rosário do Catete	Sergipe
Salgado	Sergipe
Santa Luzia do Itanhy	Sergipe
Santa Rosa de Lima	Sergipe
Santana do São Francisco	Sergipe
Santo Amaro das Brotas	Sergipe
São Cristóvão	Sergipe
São Domingos	Sergipe
São Francisco	Sergipe
São Miguel do Aleixo	Sergipe
Simão Dias	Sergipe
Siriri	Sergipe
Telha	Sergipe
Tobias Barreto	Sergipe
Tomar do Geru	Sergipe
Umbaúba	Sergipe
Abaíra	Bahia
Abaré	Bahia
Acajutiba	Bahia
Adustina	Bahia
Água Fria	Bahia
Aiquara	Bahia
Alagoinhas	Bahia
Alcobaça	Bahia
Almadina	Bahia
Amargosa	Bahia
Amélia Rodrigues	Bahia
América Dourada	Bahia
Anagé	Bahia
Andaraí	Bahia
Andorinha	Bahia
Angical	Bahia
Anguera	Bahia
Antas	Bahia
Antônio Cardoso	Bahia
Antônio Gonçalves	Bahia
Aporá	Bahia
Apuarema	Bahia
Araçás	Bahia
Aracatu	Bahia
Araci	Bahia
Aramari	Bahia
Arataca	Bahia
Aratuípe	Bahia
Aurelino Leal	Bahia
Baianópolis	Bahia
Baixa Grande	Bahia
Banzaê	Bahia
Barra	Bahia
Barra da Estiva	Bahia
Barra do Choça	Bahia
Barra do Mendes	Bahia
Barra do Rocha	Bahia
Barreiras	Bahia
Barro Alto	Bahia
Barro Preto	Bahia
Barrocas	Bahia
Belmonte	Bahia
Belo Campo	Bahia
Biritinga	Bahia
Boa Nova	Bahia
Boa Vista do Tupim	Bahia
Bom Jesus da Lapa	Bahia
Bom Jesus da Serra	Bahia
Boninal	Bahia
Bonito	Bahia
Boquira	Bahia
Botuporã	Bahia
Brejões	Bahia
Brejolândia	Bahia
Brotas de Macaúbas	Bahia
Brumado	Bahia
Buerarema	Bahia
Buritirama	Bahia
Caatiba	Bahia
Cabaceiras do Paraguaçu	Bahia
Cachoeira	Bahia
Caculé	Bahia
Caém	Bahia
Caetanos	Bahia
Caetité	Bahia
Cafarnaum	Bahia
Cairu	Bahia
Caldeirão Grande	Bahia
Camacan	Bahia
Camaçari	Bahia
Camamu	Bahia
Campo Alegre de Lourdes	Bahia
Campo Formoso	Bahia
Canápolis	Bahia
Canarana	Bahia
Canavieiras	Bahia
Candeal	Bahia
Candeias	Bahia
Candiba	Bahia
Cândido Sales	Bahia
Cansanção	Bahia
Canudos	Bahia
Capela do Alto Alegre	Bahia
Capim Grosso	Bahia
Caraíbas	Bahia
Caravelas	Bahia
Cardeal da Silva	Bahia
Carinhanha	Bahia
Casa Nova	Bahia
Castro Alves	Bahia
Catolândia	Bahia
Catu	Bahia
Caturama	Bahia
Central	Bahia
Chorrochó	Bahia
Cícero Dantas	Bahia
Cipó	Bahia
Coaraci	Bahia
Cocos	Bahia
Conceição da Feira	Bahia
Conceição do Almeida	Bahia
Conceição do Coité	Bahia
Conceição do Jacuípe	Bahia
Conde	Bahia
Condeúba	Bahia
Contendas do Sincorá	Bahia
Coração de Maria	Bahia
Cordeiros	Bahia
Coribe	Bahia
Coronel João Sá	Bahia
Correntina	Bahia
Cotegipe	Bahia
Cravolândia	Bahia
Crisópolis	Bahia
Cristópolis	Bahia
Cruz das Almas	Bahia
Curaçá	Bahia
Dário Meira	Bahia
Dias d'Ávila	Bahia
Dom Basílio	Bahia
Dom Macedo Costa	Bahia
Elísio Medrado	Bahia
Encruzilhada	Bahia
Entre Rios	Bahia
Érico Cardoso	Bahia
Esplanada	Bahia
Euclides da Cunha	Bahia
Eunápolis	Bahia
Fátima	Bahia
Feira da Mata	Bahia
Feira de Santana	Bahia
Filadélfia	Bahia
Firmino Alves	Bahia
Floresta Azul	Bahia
Formosa do Rio Preto	Bahia
Gandu	Bahia
Gavião	Bahia
Gentio do Ouro	Bahia
Glória	Bahia
Gongogi	Bahia
Governador Mangabeira	Bahia
Guajeru	Bahia
Guanambi	Bahia
Guaratinga	Bahia
Heliópolis	Bahia
Iaçu	Bahia
Ibiassucê	Bahia
Ibicaraí	Bahia
Ibicoara	Bahia
Ibicuí	Bahia
Ibipeba	Bahia
Ibipitanga	Bahia
Ibiquera	Bahia
Ibirapitanga	Bahia
Ibirapuã	Bahia
Ibirataia	Bahia
Ibitiara	Bahia
Ibititá	Bahia
Ibotirama	Bahia
Ichu	Bahia
Igaporã	Bahia
Igrapiúna	Bahia
Iguaí	Bahia
Ilhéus	Bahia
Inhambupe	Bahia
Ipecaetá	Bahia
Ipiaú	Bahia
Ipirá	Bahia
Ipupiara	Bahia
Irajuba	Bahia
Iramaia	Bahia
Iraquara	Bahia
Irará	Bahia
Irecê	Bahia
Itabela	Bahia
Itaberaba	Bahia
Itabuna	Bahia
Itacaré	Bahia
Itaeté	Bahia
Itagi	Bahia
Itagibá	Bahia
Itagimirim	Bahia
Itaguaçu da Bahia	Bahia
Itaju do Colônia	Bahia
Itajuípe	Bahia
Itamaraju	Bahia
Itamari	Bahia
Itambé	Bahia
Itanagra	Bahia
Itanhém	Bahia
Itaparica	Bahia
Itapé	Bahia
Itapebi	Bahia
Itapetinga	Bahia
Itapicuru	Bahia
Itapitanga	Bahia
Itaquara	Bahia
Itarantim	Bahia
Itatim	Bahia
Itiruçu	Bahia
Itiúba	Bahia
Itororó	Bahia
Ituaçu	Bahia
Ituberá	Bahia
Iuiu	Bahia
Jaborandi	Bahia
Jacaraci	Bahia
Jacobina	Bahia
Jaguaquara	Bahia
Jaguarari	Bahia
Jaguaripe	Bahia
Jandaíra	Bahia
Jequié	Bahia
Jeremoabo	Bahia
Jiquiriçá	Bahia
Jitaúna	Bahia
João Dourado	Bahia
Juazeiro	Bahia
Jucuruçu	Bahia
Jussara	Bahia
Jussari	Bahia
Jussiape	Bahia
Lafaiete Coutinho	Bahia
Lagoa Real	Bahia
Laje	Bahia
Lajedão	Bahia
Lajedinho	Bahia
Lajedo do Tabocal	Bahia
Lamarão	Bahia
Lapão	Bahia
Lauro de Freitas	Bahia
Lençóis	Bahia
Licínio de Almeida	Bahia
Livramento de Nossa Senhora	Bahia
Luís Eduardo Magalhães	Bahia
Macajuba	Bahia
Macarani	Bahia
Macaúbas	Bahia
Macururé	Bahia
Madre de Deus	Bahia
Maetinga	Bahia
Maiquinique	Bahia
Mairi	Bahia
Malhada	Bahia
Malhada de Pedras	Bahia
Manoel Vitorino	Bahia
Mansidão	Bahia
Maracás	Bahia
Maragogipe	Bahia
Maraú	Bahia
Marcionílio Souza	Bahia
Mascote	Bahia
Mata de São João	Bahia
Matina	Bahia
Medeiros Neto	Bahia
Miguel Calmon	Bahia
Milagres	Bahia
Mirangaba	Bahia
Mirante	Bahia
Monte Santo	Bahia
Morpará	Bahia
Morro do Chapéu	Bahia
Mortugaba	Bahia
Mucugê	Bahia
Mucuri	Bahia
Mulungu do Morro	Bahia
Mundo Novo	Bahia
Muniz Ferreira	Bahia
Muquém do São Francisco	Bahia
Muritiba	Bahia
Mutuípe	Bahia
Nazaré	Bahia
Nilo Peçanha	Bahia
Nordestina	Bahia
Nova Canaã	Bahia
Nova Fátima	Bahia
Nova Ibiá	Bahia
Nova Itarana	Bahia
Nova Redenção	Bahia
Nova Soure	Bahia
Nova Viçosa	Bahia
Novo Horizonte	Bahia
Novo Triunfo	Bahia
Olindina	Bahia
Oliveira dos Brejinhos	Bahia
Ouriçangas	Bahia
Ourolândia	Bahia
Palmas de Monte Alto	Bahia
Palmeiras	Bahia
Paramirim	Bahia
Paratinga	Bahia
Paripiranga	Bahia
Pau Brasil	Bahia
Paulo Afonso	Bahia
Pé de Serra	Bahia
Pedrão	Bahia
Pedro Alexandre	Bahia
Piatã	Bahia
Pilão Arcado	Bahia
Pindaí	Bahia
Pindobaçu	Bahia
Pintadas	Bahia
Piraí do Norte	Bahia
Piripá	Bahia
Piritiba	Bahia
Planaltino	Bahia
Planalto	Bahia
Poções	Bahia
Pojuca	Bahia
Ponto Novo	Bahia
Porto Seguro	Bahia
Potiraguá	Bahia
Prado	Bahia
Presidente Dutra	Bahia
Presidente Jânio Quadros	Bahia
Presidente Tancredo Neves	Bahia
Queimadas	Bahia
Quijingue	Bahia
Quixabeira	Bahia
Rafael Jambeiro	Bahia
Remanso	Bahia
Retirolândia	Bahia
Riachão das Neves	Bahia
Riachão do Jacuípe	Bahia
Riacho de Santana	Bahia
Ribeira do Amparo	Bahia
Ribeira do Pombal	Bahia
Ribeirão do Largo	Bahia
Rio de Contas	Bahia
Rio do Antônio	Bahia
Rio do Pires	Bahia
Rio Real	Bahia
Rodelas	Bahia
Ruy Barbosa	Bahia
Salinas da Margarida	Bahia
Salvador	Bahia
Santa Bárbara	Bahia
Santa Brígida	Bahia
Santa Cruz Cabrália	Bahia
Santa Cruz da Vitória	Bahia
Santa Inês	Bahia
Santa Luzia	Bahia
Santa Maria da Vitória	Bahia
Santa Rita de Cássia	Bahia
Santa Terezinha	Bahia
Santaluz	Bahia
Santana	Bahia
Santanópolis	Bahia
Santo Amaro	Bahia
Santo Antônio de Jesus	Bahia
Santo Estêvão	Bahia
São Desidério	Bahia
São Domingos	Bahia
São Felipe	Bahia
São Félix	Bahia
São Félix do Coribe	Bahia
São Francisco do Conde	Bahia
São Gabriel	Bahia
São Gonçalo dos Campos	Bahia
São José da Vitória	Bahia
São José do Jacuípe	Bahia
São Miguel das Matas	Bahia
São Sebastião do Passé	Bahia
Sapeaçu	Bahia
Sátiro Dias	Bahia
Saubara	Bahia
Saúde	Bahia
Seabra	Bahia
Sebastião Laranjeiras	Bahia
Senhor do Bonfim	Bahia
Sento Sé	Bahia
Serra do Ramalho	Bahia
Serra Dourada	Bahia
Serra Preta	Bahia
Serrinha	Bahia
Serrolândia	Bahia
Simões Filho	Bahia
Sítio do Mato	Bahia
Sítio do Quinto	Bahia
Sobradinho	Bahia
Souto Soares	Bahia
Tabocas do Brejo Velho	Bahia
Tanhaçu	Bahia
Tanque Novo	Bahia
Tanquinho	Bahia
Taperoá	Bahia
Tapiramutá	Bahia
Teixeira de Freitas	Bahia
Teodoro Sampaio	Bahia
Teofilândia	Bahia
Teolândia	Bahia
Terra Nova	Bahia
Tremedal	Bahia
Tucano	Bahia
Uauá	Bahia
Ubaíra	Bahia
Ubaitaba	Bahia
Ubatã	Bahia
Uibaí	Bahia
Umburanas	Bahia
Una	Bahia
Urandi	Bahia
Uruçuca	Bahia
Utinga	Bahia
Valença	Bahia
Valente	Bahia
Várzea da Roça	Bahia
Várzea do Poço	Bahia
Várzea Nova	Bahia
Varzedo	Bahia
Vera Cruz	Bahia
Vereda	Bahia
Vitória da Conquista	Bahia
Wagner	Bahia
Wanderley	Bahia
Wenceslau Guimarães	Bahia
Xique-Xique	Bahia
Abadia dos Dourados	Minas Gerais
Abaeté	Minas Gerais
Abre Campo	Minas Gerais
Acaiaca	Minas Gerais
Açucena	Minas Gerais
Água Boa	Minas Gerais
Água Comprida	Minas Gerais
Aguanil	Minas Gerais
Águas Formosas	Minas Gerais
Águas Vermelhas	Minas Gerais
Aimorés	Minas Gerais
Aiuruoca	Minas Gerais
Alagoa	Minas Gerais
Albertina	Minas Gerais
Além Paraíba	Minas Gerais
Alfenas	Minas Gerais
Alfredo Vasconcelos	Minas Gerais
Almenara	Minas Gerais
Alpercata	Minas Gerais
Alpinópolis	Minas Gerais
Alterosa	Minas Gerais
Alto Caparaó	Minas Gerais
Alto Jequitibá	Minas Gerais
Alto Rio Doce	Minas Gerais
Alvarenga	Minas Gerais
Alvinópolis	Minas Gerais
Alvorada de Minas	Minas Gerais
Amparo do Serra	Minas Gerais
Andradas	Minas Gerais
Andrelândia	Minas Gerais
Angelândia	Minas Gerais
Antônio Carlos	Minas Gerais
Antônio Dias	Minas Gerais
Antônio Prado de Minas	Minas Gerais
Araçaí	Minas Gerais
Aracitaba	Minas Gerais
Araçuaí	Minas Gerais
Araguari	Minas Gerais
Arantina	Minas Gerais
Araponga	Minas Gerais
Araporã	Minas Gerais
Arapuá	Minas Gerais
Araújos	Minas Gerais
Araxá	Minas Gerais
Arceburgo	Minas Gerais
Arcos	Minas Gerais
Areado	Minas Gerais
Argirita	Minas Gerais
Aricanduva	Minas Gerais
Arinos	Minas Gerais
Astolfo Dutra	Minas Gerais
Ataléia	Minas Gerais
Augusto de Lima	Minas Gerais
Baependi	Minas Gerais
Baldim	Minas Gerais
Bambuí	Minas Gerais
Bandeira	Minas Gerais
Bandeira do Sul	Minas Gerais
Barão de Cocais	Minas Gerais
Barão de Monte Alto	Minas Gerais
Barbacena	Minas Gerais
Barra Longa	Minas Gerais
Barroso	Minas Gerais
Bela Vista de Minas	Minas Gerais
Belmiro Braga	Minas Gerais
Belo Horizonte	Minas Gerais
Belo Oriente	Minas Gerais
Belo Vale	Minas Gerais
Berilo	Minas Gerais
Berizal	Minas Gerais
Bertópolis	Minas Gerais
Betim	Minas Gerais
Bias Fortes	Minas Gerais
Bicas	Minas Gerais
Biquinhas	Minas Gerais
Boa Esperança	Minas Gerais
Bocaina de Minas	Minas Gerais
Bocaiúva	Minas Gerais
Bom Despacho	Minas Gerais
Bom Jardim de Minas	Minas Gerais
Bom Jesus da Penha	Minas Gerais
Bom Jesus do Amparo	Minas Gerais
Bom Jesus do Galho	Minas Gerais
Bom Repouso	Minas Gerais
Bom Sucesso	Minas Gerais
Bonfim	Minas Gerais
Bonfinópolis de Minas	Minas Gerais
Bonito de Minas	Minas Gerais
Borda da Mata	Minas Gerais
Botelhos	Minas Gerais
Botumirim	Minas Gerais
Brás Pires	Minas Gerais
Brasilândia de Minas	Minas Gerais
Brasília de Minas	Minas Gerais
Braúnas	Minas Gerais
Brazópolis	Minas Gerais
Brumadinho	Minas Gerais
Bueno Brandão	Minas Gerais
Buenópolis	Minas Gerais
Bugre	Minas Gerais
Buritis	Minas Gerais
Buritizeiro	Minas Gerais
Cabeceira Grande	Minas Gerais
Cabo Verde	Minas Gerais
Cachoeira da Prata	Minas Gerais
Cachoeira de Minas	Minas Gerais
Cachoeira de Pajeú	Minas Gerais
Cachoeira Dourada	Minas Gerais
Caetanópolis	Minas Gerais
Caeté	Minas Gerais
Caiana	Minas Gerais
Cajuri	Minas Gerais
Caldas	Minas Gerais
Camacho	Minas Gerais
Camanducaia	Minas Gerais
Cambuí	Minas Gerais
Cambuquira	Minas Gerais
Campanário	Minas Gerais
Campanha	Minas Gerais
Campestre	Minas Gerais
Campina Verde	Minas Gerais
Campo Azul	Minas Gerais
Campo Belo	Minas Gerais
Campo do Meio	Minas Gerais
Campo Florido	Minas Gerais
Campos Altos	Minas Gerais
Campos Gerais	Minas Gerais
Cana Verde	Minas Gerais
Canaã	Minas Gerais
Canápolis	Minas Gerais
Candeias	Minas Gerais
Cantagalo	Minas Gerais
Caparaó	Minas Gerais
Capela Nova	Minas Gerais
Capelinha	Minas Gerais
Capetinga	Minas Gerais
Capim Branco	Minas Gerais
Capinópolis	Minas Gerais
Capitão Andrade	Minas Gerais
Capitão Enéas	Minas Gerais
Capitólio	Minas Gerais
Caputira	Minas Gerais
Caraí	Minas Gerais
Caranaíba	Minas Gerais
Carandaí	Minas Gerais
Carangola	Minas Gerais
Caratinga	Minas Gerais
Carbonita	Minas Gerais
Careaçu	Minas Gerais
Carlos Chagas	Minas Gerais
Carmésia	Minas Gerais
Carmo da Cachoeira	Minas Gerais
Carmo da Mata	Minas Gerais
Carmo de Minas	Minas Gerais
Carmo do Cajuru	Minas Gerais
Carmo do Paranaíba	Minas Gerais
Carmo do Rio Claro	Minas Gerais
Carmópolis de Minas	Minas Gerais
Carneirinho	Minas Gerais
Carrancas	Minas Gerais
Carvalhópolis	Minas Gerais
Carvalhos	Minas Gerais
Casa Grande	Minas Gerais
Cascalho Rico	Minas Gerais
Cássia	Minas Gerais
Cataguases	Minas Gerais
Catas Altas	Minas Gerais
Catas Altas da Noruega	Minas Gerais
Catuji	Minas Gerais
Catuti	Minas Gerais
Caxambu	Minas Gerais
Cedro do Abaeté	Minas Gerais
Central de Minas	Minas Gerais
Centralina	Minas Gerais
Chácara	Minas Gerais
Chalé	Minas Gerais
Chapada do Norte	Minas Gerais
Chapada Gaúcha	Minas Gerais
Chiador	Minas Gerais
Cipotânea	Minas Gerais
Claraval	Minas Gerais
Claro dos Poções	Minas Gerais
Cláudio	Minas Gerais
Coimbra	Minas Gerais
Coluna	Minas Gerais
Comendador Gomes	Minas Gerais
Comercinho	Minas Gerais
Conceição da Aparecida	Minas Gerais
Conceição da Barra de Minas	Minas Gerais
Conceição das Alagoas	Minas Gerais
Conceição das Pedras	Minas Gerais
Conceição de Ipanema	Minas Gerais
Conceição do Mato Dentro	Minas Gerais
Conceição do Pará	Minas Gerais
Conceição do Rio Verde	Minas Gerais
Conceição dos Ouros	Minas Gerais
Cônego Marinho	Minas Gerais
Confins	Minas Gerais
Congonhal	Minas Gerais
Congonhas	Minas Gerais
Congonhas do Norte	Minas Gerais
Conquista	Minas Gerais
Conselheiro Lafaiete	Minas Gerais
Conselheiro Pena	Minas Gerais
Consolação	Minas Gerais
Contagem	Minas Gerais
Coqueiral	Minas Gerais
Coração de Jesus	Minas Gerais
Cordisburgo	Minas Gerais
Cordislândia	Minas Gerais
Corinto	Minas Gerais
Coroaci	Minas Gerais
Coromandel	Minas Gerais
Coronel Fabriciano	Minas Gerais
Coronel Murta	Minas Gerais
Coronel Pacheco	Minas Gerais
Coronel Xavier Chaves	Minas Gerais
Córrego Danta	Minas Gerais
Córrego do Bom Jesus	Minas Gerais
Córrego Fundo	Minas Gerais
Córrego Novo	Minas Gerais
Couto de Magalhães de Minas	Minas Gerais
Crisólita	Minas Gerais
Cristais	Minas Gerais
Cristália	Minas Gerais
Cristiano Otoni	Minas Gerais
Cristina	Minas Gerais
Crucilândia	Minas Gerais
Cruzeiro da Fortaleza	Minas Gerais
Cruzília	Minas Gerais
Cuparaque	Minas Gerais
Curral de Dentro	Minas Gerais
Curvelo	Minas Gerais
Datas	Minas Gerais
Delfim Moreira	Minas Gerais
Delfinópolis	Minas Gerais
Delta	Minas Gerais
Descoberto	Minas Gerais
Desterro de Entre Rios	Minas Gerais
Desterro do Melo	Minas Gerais
Diamantina	Minas Gerais
Diogo de Vasconcelos	Minas Gerais
Dionísio	Minas Gerais
Divinésia	Minas Gerais
Divino	Minas Gerais
Divino das Laranjeiras	Minas Gerais
Divinolândia de Minas	Minas Gerais
Divinópolis	Minas Gerais
Divisa Alegre	Minas Gerais
Divisa Nova	Minas Gerais
Divisópolis	Minas Gerais
Dom Bosco	Minas Gerais
Dom Cavati	Minas Gerais
Dom Joaquim	Minas Gerais
Dom Silvério	Minas Gerais
Dom Viçoso	Minas Gerais
Dona Eusébia	Minas Gerais
Dores de Campos	Minas Gerais
Dores de Guanhães	Minas Gerais
Dores do Indaiá	Minas Gerais
Dores do Turvo	Minas Gerais
Doresópolis	Minas Gerais
Douradoquara	Minas Gerais
Durandé	Minas Gerais
Elói Mendes	Minas Gerais
Engenheiro Caldas	Minas Gerais
Engenheiro Navarro	Minas Gerais
Entre Folhas	Minas Gerais
Entre Rios de Minas	Minas Gerais
Ervália	Minas Gerais
Esmeraldas	Minas Gerais
Espera Feliz	Minas Gerais
Espinosa	Minas Gerais
Espírito Santo do Dourado	Minas Gerais
Estiva	Minas Gerais
Estrela Dalva	Minas Gerais
Estrela do Indaiá	Minas Gerais
Estrela do Sul	Minas Gerais
Eugenópolis	Minas Gerais
Ewbank da Câmara	Minas Gerais
Extrema	Minas Gerais
Fama	Minas Gerais
Faria Lemos	Minas Gerais
Felício dos Santos	Minas Gerais
Felisburgo	Minas Gerais
Felixlândia	Minas Gerais
Fernandes Tourinho	Minas Gerais
Ferros	Minas Gerais
Fervedouro	Minas Gerais
Florestal	Minas Gerais
Formiga	Minas Gerais
Formoso	Minas Gerais
Fortaleza de Minas	Minas Gerais
Fortuna de Minas	Minas Gerais
Francisco Badaró	Minas Gerais
Francisco Dumont	Minas Gerais
Francisco Sá	Minas Gerais
Franciscópolis	Minas Gerais
Frei Gaspar	Minas Gerais
Frei Inocêncio	Minas Gerais
Frei Lagonegro	Minas Gerais
Fronteira	Minas Gerais
Fronteira dos Vales	Minas Gerais
Fruta de Leite	Minas Gerais
Frutal	Minas Gerais
Funilândia	Minas Gerais
Galiléia	Minas Gerais
Gameleiras	Minas Gerais
Glaucilândia	Minas Gerais
Goiabeira	Minas Gerais
Goianá	Minas Gerais
Gonçalves	Minas Gerais
Gonzaga	Minas Gerais
Gouveia	Minas Gerais
Governador Valadares	Minas Gerais
Grão Mogol	Minas Gerais
Grupiara	Minas Gerais
Guanhães	Minas Gerais
Guapé	Minas Gerais
Guaraciaba	Minas Gerais
Guaraciama	Minas Gerais
Guaranésia	Minas Gerais
Guarani	Minas Gerais
Guarará	Minas Gerais
Guarda-Mor	Minas Gerais
Guaxupé	Minas Gerais
Guidoval	Minas Gerais
Guimarânia	Minas Gerais
Guiricema	Minas Gerais
Gurinhatã	Minas Gerais
Heliodora	Minas Gerais
Iapu	Minas Gerais
Ibertioga	Minas Gerais
Ibiá	Minas Gerais
Ibiaí	Minas Gerais
Ibiracatu	Minas Gerais
Ibiraci	Minas Gerais
Ibirité	Minas Gerais
Ibitiúra de Minas	Minas Gerais
Ibituruna	Minas Gerais
Icaraí de Minas	Minas Gerais
Igarapé	Minas Gerais
Igaratinga	Minas Gerais
Iguatama	Minas Gerais
Ijaci	Minas Gerais
Ilicínea	Minas Gerais
Imbé de Minas	Minas Gerais
Inconfidentes	Minas Gerais
Indaiabira	Minas Gerais
Indianópolis	Minas Gerais
Ingaí	Minas Gerais
Inhapim	Minas Gerais
Inhaúma	Minas Gerais
Inimutaba	Minas Gerais
Ipaba	Minas Gerais
Ipanema	Minas Gerais
Ipatinga	Minas Gerais
Ipiaçu	Minas Gerais
Ipuiúna	Minas Gerais
Iraí de Minas	Minas Gerais
Itabira	Minas Gerais
Itabirinha	Minas Gerais
Itabirito	Minas Gerais
Itacambira	Minas Gerais
Itacarambi	Minas Gerais
Itaguara	Minas Gerais
Itaipé	Minas Gerais
Itajubá	Minas Gerais
Itamarandiba	Minas Gerais
Itamarati de Minas	Minas Gerais
Itambacuri	Minas Gerais
Itambé do Mato Dentro	Minas Gerais
Itamogi	Minas Gerais
Itamonte	Minas Gerais
Itanhandu	Minas Gerais
Itanhomi	Minas Gerais
Itaobim	Minas Gerais
Itapagipe	Minas Gerais
Itapecerica	Minas Gerais
Itapeva	Minas Gerais
Itatiaiuçu	Minas Gerais
Itaú de Minas	Minas Gerais
Itaúna	Minas Gerais
Itaverava	Minas Gerais
Itinga	Minas Gerais
Itueta	Minas Gerais
Ituiutaba	Minas Gerais
Itumirim	Minas Gerais
Iturama	Minas Gerais
Itutinga	Minas Gerais
Jaboticatubas	Minas Gerais
Jacinto	Minas Gerais
Jacuí	Minas Gerais
Jacutinga	Minas Gerais
Jaguaraçu	Minas Gerais
Jaíba	Minas Gerais
Jampruca	Minas Gerais
Janaúba	Minas Gerais
Januária	Minas Gerais
Japaraíba	Minas Gerais
Japonvar	Minas Gerais
Jeceaba	Minas Gerais
Jenipapo de Minas	Minas Gerais
Jequeri	Minas Gerais
Jequitaí	Minas Gerais
Jequitibá	Minas Gerais
Jequitinhonha	Minas Gerais
Jesuânia	Minas Gerais
Joaíma	Minas Gerais
Joanésia	Minas Gerais
João Monlevade	Minas Gerais
João Pinheiro	Minas Gerais
Joaquim Felício	Minas Gerais
Jordânia	Minas Gerais
José Gonçalves de Minas	Minas Gerais
José Raydan	Minas Gerais
Josenópolis	Minas Gerais
Juatuba	Minas Gerais
Juiz de Fora	Minas Gerais
Juramento	Minas Gerais
Juruaia	Minas Gerais
Juvenília	Minas Gerais
Ladainha	Minas Gerais
Lagamar	Minas Gerais
Lagoa da Prata	Minas Gerais
Lagoa dos Patos	Minas Gerais
Lagoa Dourada	Minas Gerais
Lagoa Formosa	Minas Gerais
Lagoa Grande	Minas Gerais
Lagoa Santa	Minas Gerais
Lajinha	Minas Gerais
Lambari	Minas Gerais
Lamim	Minas Gerais
Laranjal	Minas Gerais
Lassance	Minas Gerais
Lavras	Minas Gerais
Leandro Ferreira	Minas Gerais
Leme do Prado	Minas Gerais
Leopoldina	Minas Gerais
Liberdade	Minas Gerais
Lima Duarte	Minas Gerais
Limeira do Oeste	Minas Gerais
Lontra	Minas Gerais
Luisburgo	Minas Gerais
Luislândia	Minas Gerais
Luminárias	Minas Gerais
Luz	Minas Gerais
Machacalis	Minas Gerais
Machado	Minas Gerais
Madre de Deus de Minas	Minas Gerais
Malacacheta	Minas Gerais
Mamonas	Minas Gerais
Manga	Minas Gerais
Manhuaçu	Minas Gerais
Manhumirim	Minas Gerais
Mantena	Minas Gerais
Mar de Espanha	Minas Gerais
Maravilhas	Minas Gerais
Maria da Fé	Minas Gerais
Mariana	Minas Gerais
Marilac	Minas Gerais
Mário Campos	Minas Gerais
Maripá de Minas	Minas Gerais
Marliéria	Minas Gerais
Marmelópolis	Minas Gerais
Martinho Campos	Minas Gerais
Martins Soares	Minas Gerais
Mata Verde	Minas Gerais
Materlândia	Minas Gerais
Mateus Leme	Minas Gerais
Mathias Lobato	Minas Gerais
Matias Barbosa	Minas Gerais
Matias Cardoso	Minas Gerais
Matipó	Minas Gerais
Mato Verde	Minas Gerais
Matozinhos	Minas Gerais
Matutina	Minas Gerais
Medeiros	Minas Gerais
Medina	Minas Gerais
Mendes Pimentel	Minas Gerais
Mercês	Minas Gerais
Mesquita	Minas Gerais
Minas Novas	Minas Gerais
Minduri	Minas Gerais
Mirabela	Minas Gerais
Miradouro	Minas Gerais
Miraí	Minas Gerais
Miravânia	Minas Gerais
Moeda	Minas Gerais
Moema	Minas Gerais
Monjolos	Minas Gerais
Monsenhor Paulo	Minas Gerais
Montalvânia	Minas Gerais
Monte Alegre de Minas	Minas Gerais
Monte Azul	Minas Gerais
Monte Belo	Minas Gerais
Monte Carmelo	Minas Gerais
Monte Formoso	Minas Gerais
Monte Santo de Minas	Minas Gerais
Monte Sião	Minas Gerais
Montes Claros	Minas Gerais
Montezuma	Minas Gerais
Morada Nova de Minas	Minas Gerais
Morro da Garça	Minas Gerais
Morro do Pilar	Minas Gerais
Munhoz	Minas Gerais
Muriaé	Minas Gerais
Mutum	Minas Gerais
Muzambinho	Minas Gerais
Nacip Raydan	Minas Gerais
Nanuque	Minas Gerais
Naque	Minas Gerais
Natalândia	Minas Gerais
Natércia	Minas Gerais
Nazareno	Minas Gerais
Nepomuceno	Minas Gerais
Ninheira	Minas Gerais
Nova Belém	Minas Gerais
Nova Era	Minas Gerais
Nova Lima	Minas Gerais
Nova Módica	Minas Gerais
Nova Ponte	Minas Gerais
Nova Porteirinha	Minas Gerais
Nova Resende	Minas Gerais
Nova Serrana	Minas Gerais
Nova União	Minas Gerais
Novo Cruzeiro	Minas Gerais
Novo Oriente de Minas	Minas Gerais
Novorizonte	Minas Gerais
Olaria	Minas Gerais
Olhos-d'Água	Minas Gerais
Olímpio Noronha	Minas Gerais
Oliveira	Minas Gerais
Oliveira Fortes	Minas Gerais
Onça de Pitangui	Minas Gerais
Oratórios	Minas Gerais
Orizânia	Minas Gerais
Ouro Branco	Minas Gerais
Ouro Fino	Minas Gerais
Ouro Preto	Minas Gerais
Ouro Verde de Minas	Minas Gerais
Padre Carvalho	Minas Gerais
Padre Paraíso	Minas Gerais
Pai Pedro	Minas Gerais
Paineiras	Minas Gerais
Pains	Minas Gerais
Paiva	Minas Gerais
Palma	Minas Gerais
Palmópolis	Minas Gerais
Papagaios	Minas Gerais
Pará de Minas	Minas Gerais
Paracatu	Minas Gerais
Paraguaçu	Minas Gerais
Paraisópolis	Minas Gerais
Paraopeba	Minas Gerais
Passa Quatro	Minas Gerais
Passa Tempo	Minas Gerais
Passa Vinte	Minas Gerais
Passabém	Minas Gerais
Passos	Minas Gerais
Patis	Minas Gerais
Patos de Minas	Minas Gerais
Patrocínio	Minas Gerais
Patrocínio do Muriaé	Minas Gerais
Paula Cândido	Minas Gerais
Paulistas	Minas Gerais
Pavão	Minas Gerais
Peçanha	Minas Gerais
Pedra Azul	Minas Gerais
Pedra Bonita	Minas Gerais
Pedra do Anta	Minas Gerais
Pedra do Indaiá	Minas Gerais
Pedra Dourada	Minas Gerais
Pedralva	Minas Gerais
Pedras de Maria da Cruz	Minas Gerais
Pedrinópolis	Minas Gerais
Pedro Leopoldo	Minas Gerais
Pedro Teixeira	Minas Gerais
Pequeri	Minas Gerais
Pequi	Minas Gerais
Perdigão	Minas Gerais
Perdizes	Minas Gerais
Perdões	Minas Gerais
Periquito	Minas Gerais
Pescador	Minas Gerais
Piau	Minas Gerais
Piedade de Caratinga	Minas Gerais
Piedade de Ponte Nova	Minas Gerais
Piedade do Rio Grande	Minas Gerais
Piedade dos Gerais	Minas Gerais
Pimenta	Minas Gerais
Pingo d'Água	Minas Gerais
Pintópolis	Minas Gerais
Piracema	Minas Gerais
Pirajuba	Minas Gerais
Piranga	Minas Gerais
Piranguçu	Minas Gerais
Piranguinho	Minas Gerais
Pirapetinga	Minas Gerais
Pirapora	Minas Gerais
Piraúba	Minas Gerais
Pitangui	Minas Gerais
Piumhi	Minas Gerais
Planura	Minas Gerais
Poço Fundo	Minas Gerais
Poços de Caldas	Minas Gerais
Pocrane	Minas Gerais
Pompéu	Minas Gerais
Ponte Nova	Minas Gerais
Ponto Chique	Minas Gerais
Ponto dos Volantes	Minas Gerais
Porteirinha	Minas Gerais
Porto Firme	Minas Gerais
Poté	Minas Gerais
Pouso Alegre	Minas Gerais
Pouso Alto	Minas Gerais
Prados	Minas Gerais
Prata	Minas Gerais
Pratápolis	Minas Gerais
Pratinha	Minas Gerais
Presidente Bernardes	Minas Gerais
Presidente Juscelino	Minas Gerais
Presidente Kubitschek	Minas Gerais
Presidente Olegário	Minas Gerais
Prudente de Morais	Minas Gerais
Quartel Geral	Minas Gerais
Queluzito	Minas Gerais
Raposos	Minas Gerais
Raul Soares	Minas Gerais
Recreio	Minas Gerais
Reduto	Minas Gerais
Resende Costa	Minas Gerais
Resplendor	Minas Gerais
Ressaquinha	Minas Gerais
Riachinho	Minas Gerais
Riacho dos Machados	Minas Gerais
Ribeirão das Neves	Minas Gerais
Ribeirão Vermelho	Minas Gerais
Rio Acima	Minas Gerais
Rio Casca	Minas Gerais
Rio do Prado	Minas Gerais
Rio Doce	Minas Gerais
Rio Espera	Minas Gerais
Rio Manso	Minas Gerais
Rio Novo	Minas Gerais
Rio Paranaíba	Minas Gerais
Rio Pardo de Minas	Minas Gerais
Rio Piracicaba	Minas Gerais
Rio Pomba	Minas Gerais
Rio Preto	Minas Gerais
Rio Vermelho	Minas Gerais
Ritápolis	Minas Gerais
Rochedo de Minas	Minas Gerais
Rodeiro	Minas Gerais
Romaria	Minas Gerais
Rosário da Limeira	Minas Gerais
Rubelita	Minas Gerais
Rubim	Minas Gerais
Sabará	Minas Gerais
Sabinópolis	Minas Gerais
Sacramento	Minas Gerais
Salinas	Minas Gerais
Salto da Divisa	Minas Gerais
Santa Bárbara	Minas Gerais
Santa Bárbara do Leste	Minas Gerais
Santa Bárbara do Monte Verde	Minas Gerais
Santa Bárbara do Tugúrio	Minas Gerais
Santa Cruz de Minas	Minas Gerais
Santa Cruz de Salinas	Minas Gerais
Santa Cruz do Escalvado	Minas Gerais
Santa Efigênia de Minas	Minas Gerais
Santa Fé de Minas	Minas Gerais
Santa Helena de Minas	Minas Gerais
Santa Juliana	Minas Gerais
Santa Luzia	Minas Gerais
Santa Margarida	Minas Gerais
Santa Maria de Itabira	Minas Gerais
Santa Maria do Salto	Minas Gerais
Santa Maria do Suaçuí	Minas Gerais
Santa Rita de Caldas	Minas Gerais
Santa Rita de Ibitipoca	Minas Gerais
Santa Rita de Jacutinga	Minas Gerais
Santa Rita de Minas	Minas Gerais
Santa Rita do Itueto	Minas Gerais
Santa Rita do Sapucaí	Minas Gerais
Santa Rosa da Serra	Minas Gerais
Santa Vitória	Minas Gerais
Santana da Vargem	Minas Gerais
Santana de Cataguases	Minas Gerais
Santana de Pirapama	Minas Gerais
Santana do Deserto	Minas Gerais
Santana do Garambéu	Minas Gerais
Santana do Jacaré	Minas Gerais
Santana do Manhuaçu	Minas Gerais
Santana do Paraíso	Minas Gerais
Santana do Riacho	Minas Gerais
Santana dos Montes	Minas Gerais
Santo Antônio do Amparo	Minas Gerais
Santo Antônio do Aventureiro	Minas Gerais
Santo Antônio do Grama	Minas Gerais
Santo Antônio do Itambé	Minas Gerais
Santo Antônio do Jacinto	Minas Gerais
Santo Antônio do Monte	Minas Gerais
Santo Antônio do Retiro	Minas Gerais
Santo Antônio do Rio Abaixo	Minas Gerais
Santo Hipólito	Minas Gerais
Santos Dumont	Minas Gerais
São Bento Abade	Minas Gerais
São Brás do Suaçuí	Minas Gerais
São Domingos das Dores	Minas Gerais
São Domingos do Prata	Minas Gerais
São Félix de Minas	Minas Gerais
São Francisco	Minas Gerais
São Francisco de Paula	Minas Gerais
São Francisco de Sales	Minas Gerais
São Francisco do Glória	Minas Gerais
São Geraldo	Minas Gerais
São Geraldo da Piedade	Minas Gerais
São Geraldo do Baixio	Minas Gerais
São Gonçalo do Abaeté	Minas Gerais
São Gonçalo do Pará	Minas Gerais
São Gonçalo do Rio Abaixo	Minas Gerais
São Gonçalo do Rio Preto	Minas Gerais
São Gonçalo do Sapucaí	Minas Gerais
São Gotardo	Minas Gerais
São João Batista do Glória	Minas Gerais
São João da Lagoa	Minas Gerais
São João da Mata	Minas Gerais
São João da Ponte	Minas Gerais
São João das Missões	Minas Gerais
São João del Rei	Minas Gerais
São João do Manhuaçu	Minas Gerais
São João do Manteninha	Minas Gerais
São João do Oriente	Minas Gerais
São João do Pacuí	Minas Gerais
São João do Paraíso	Minas Gerais
São João Evangelista	Minas Gerais
São João Nepomuceno	Minas Gerais
São Joaquim de Bicas	Minas Gerais
São José da Barra	Minas Gerais
São José da Lapa	Minas Gerais
São José da Safira	Minas Gerais
São José da Varginha	Minas Gerais
São José do Alegre	Minas Gerais
São José do Divino	Minas Gerais
São José do Goiabal	Minas Gerais
São José do Jacuri	Minas Gerais
São José do Mantimento	Minas Gerais
São Lourenço	Minas Gerais
São Miguel do Anta	Minas Gerais
São Pedro da União	Minas Gerais
São Pedro do Suaçuí	Minas Gerais
São Pedro dos Ferros	Minas Gerais
São Romão	Minas Gerais
São Roque de Minas	Minas Gerais
São Sebastião da Bela Vista	Minas Gerais
São Sebastião da Vargem Alegre	Minas Gerais
São Sebastião do Anta	Minas Gerais
São Sebastião do Maranhão	Minas Gerais
São Sebastião do Oeste	Minas Gerais
São Sebastião do Paraíso	Minas Gerais
São Sebastião do Rio Preto	Minas Gerais
São Sebastião do Rio Verde	Minas Gerais
São Thomé das Letras	Minas Gerais
São Tiago	Minas Gerais
São Tomás de Aquino	Minas Gerais
São Vicente de Minas	Minas Gerais
Sapucaí-Mirim	Minas Gerais
Sardoá	Minas Gerais
Sarzedo	Minas Gerais
Sem-Peixe	Minas Gerais
Senador Amaral	Minas Gerais
Senador Cortes	Minas Gerais
Senador Firmino	Minas Gerais
Senador José Bento	Minas Gerais
Senador Modestino Gonçalves	Minas Gerais
Senhora de Oliveira	Minas Gerais
Senhora do Porto	Minas Gerais
Senhora dos Remédios	Minas Gerais
Sericita	Minas Gerais
Seritinga	Minas Gerais
Serra Azul de Minas	Minas Gerais
Serra da Saudade	Minas Gerais
Serra do Salitre	Minas Gerais
Serra dos Aimorés	Minas Gerais
Serrania	Minas Gerais
Serranópolis de Minas	Minas Gerais
Serranos	Minas Gerais
Serro	Minas Gerais
Sete Lagoas	Minas Gerais
Setubinha	Minas Gerais
Silveirânia	Minas Gerais
Silvianópolis	Minas Gerais
Simão Pereira	Minas Gerais
Simonésia	Minas Gerais
Sobrália	Minas Gerais
Soledade de Minas	Minas Gerais
Tabuleiro	Minas Gerais
Taiobeiras	Minas Gerais
Taparuba	Minas Gerais
Tapira	Minas Gerais
Tapiraí	Minas Gerais
Taquaraçu de Minas	Minas Gerais
Tarumirim	Minas Gerais
Teixeiras	Minas Gerais
Teófilo Otoni	Minas Gerais
Timóteo	Minas Gerais
Tiradentes	Minas Gerais
Tiros	Minas Gerais
Tocantins	Minas Gerais
Tocos do Moji	Minas Gerais
Toledo	Minas Gerais
Tombos	Minas Gerais
Três Corações	Minas Gerais
Três Marias	Minas Gerais
Três Pontas	Minas Gerais
Tumiritinga	Minas Gerais
Tupaciguara	Minas Gerais
Turmalina	Minas Gerais
Turvolândia	Minas Gerais
Ubá	Minas Gerais
Ubaí	Minas Gerais
Ubaporanga	Minas Gerais
Uberaba	Minas Gerais
Uberlândia	Minas Gerais
Umburatiba	Minas Gerais
Unaí	Minas Gerais
União de Minas	Minas Gerais
Uruana de Minas	Minas Gerais
Urucânia	Minas Gerais
Urucuia	Minas Gerais
Vargem Alegre	Minas Gerais
Vargem Bonita	Minas Gerais
Vargem Grande do Rio Pardo	Minas Gerais
Varginha	Minas Gerais
Varjão de Minas	Minas Gerais
Várzea da Palma	Minas Gerais
Varzelândia	Minas Gerais
Vazante	Minas Gerais
Verdelândia	Minas Gerais
Veredinha	Minas Gerais
Veríssimo	Minas Gerais
Vermelho Novo	Minas Gerais
Vespasiano	Minas Gerais
Viçosa	Minas Gerais
Vieiras	Minas Gerais
Virgem da Lapa	Minas Gerais
Virgínia	Minas Gerais
Virginópolis	Minas Gerais
Virgolândia	Minas Gerais
Visconde do Rio Branco	Minas Gerais
Volta Grande	Minas Gerais
Wenceslau Braz	Minas Gerais
Afonso Cláudio	Espírito Santo
Água Doce do Norte	Espírito Santo
Águia Branca	Espírito Santo
Alegre	Espírito Santo
Alfredo Chaves	Espírito Santo
Alto Rio Novo	Espírito Santo
Anchieta	Espírito Santo
Apiacá	Espírito Santo
Aracruz	Espírito Santo
Atílio Vivacqua	Espírito Santo
Baixo Guandu	Espírito Santo
Barra de São Francisco	Espírito Santo
Boa Esperança	Espírito Santo
Bom Jesus do Norte	Espírito Santo
Brejetuba	Espírito Santo
Cachoeiro de Itapemirim	Espírito Santo
Cariacica	Espírito Santo
Castelo	Espírito Santo
Colatina	Espírito Santo
Conceição da Barra	Espírito Santo
Conceição do Castelo	Espírito Santo
Divino de São Lourenço	Espírito Santo
Domingos Martins	Espírito Santo
Dores do Rio Preto	Espírito Santo
Ecoporanga	Espírito Santo
Fundão	Espírito Santo
Governador Lindenberg	Espírito Santo
Guaçuí	Espírito Santo
Guarapari	Espírito Santo
Ibatiba	Espírito Santo
Ibiraçu	Espírito Santo
Ibitirama	Espírito Santo
Iconha	Espírito Santo
Irupi	Espírito Santo
Itaguaçu	Espírito Santo
Itapemirim	Espírito Santo
Itarana	Espírito Santo
Iúna	Espírito Santo
Jaguaré	Espírito Santo
Jerônimo Monteiro	Espírito Santo
João Neiva	Espírito Santo
Laranja da Terra	Espírito Santo
Linhares	Espírito Santo
Mantenópolis	Espírito Santo
Marataízes	Espírito Santo
Marechal Floriano	Espírito Santo
Marilândia	Espírito Santo
Mimoso do Sul	Espírito Santo
Montanha	Espírito Santo
Mucurici	Espírito Santo
Muniz Freire	Espírito Santo
Muqui	Espírito Santo
Nova Venécia	Espírito Santo
Pancas	Espírito Santo
Pedro Canário	Espírito Santo
Pinheiros	Espírito Santo
Piúma	Espírito Santo
Ponto Belo	Espírito Santo
Presidente Kennedy	Espírito Santo
Rio Bananal	Espírito Santo
Rio Novo do Sul	Espírito Santo
Santa Leopoldina	Espírito Santo
Santa Maria de Jetibá	Espírito Santo
Santa Teresa	Espírito Santo
São Domingos do Norte	Espírito Santo
São Gabriel da Palha	Espírito Santo
São José do Calçado	Espírito Santo
São Mateus	Espírito Santo
São Roque do Canaã	Espírito Santo
Serra	Espírito Santo
Sooretama	Espírito Santo
Vargem Alta	Espírito Santo
Venda Nova do Imigrante	Espírito Santo
Viana	Espírito Santo
Vila Pavão	Espírito Santo
Vila Valério	Espírito Santo
Vila Velha	Espírito Santo
Vitória	Espírito Santo
Angra dos Reis	Rio de Janeiro
Aperibé	Rio de Janeiro
Araruama	Rio de Janeiro
Areal	Rio de Janeiro
Armação dos Búzios	Rio de Janeiro
Arraial do Cabo	Rio de Janeiro
Barra do Piraí	Rio de Janeiro
Barra Mansa	Rio de Janeiro
Belford Roxo	Rio de Janeiro
Bom Jardim	Rio de Janeiro
Bom Jesus do Itabapoana	Rio de Janeiro
Cabo Frio	Rio de Janeiro
Cachoeiras de Macacu	Rio de Janeiro
Cambuci	Rio de Janeiro
Campos dos Goytacazes	Rio de Janeiro
Cantagalo	Rio de Janeiro
Carapebus	Rio de Janeiro
Cardoso Moreira	Rio de Janeiro
Carmo	Rio de Janeiro
Casimiro de Abreu	Rio de Janeiro
Comendador Levy Gasparian	Rio de Janeiro
Conceição de Macabu	Rio de Janeiro
Cordeiro	Rio de Janeiro
Duas Barras	Rio de Janeiro
Duque de Caxias	Rio de Janeiro
Engenheiro Paulo de Frontin	Rio de Janeiro
Guapimirim	Rio de Janeiro
Iguaba Grande	Rio de Janeiro
Itaboraí	Rio de Janeiro
Itaguaí	Rio de Janeiro
Italva	Rio de Janeiro
Itaocara	Rio de Janeiro
Itaperuna	Rio de Janeiro
Itatiaia	Rio de Janeiro
Japeri	Rio de Janeiro
Laje do Muriaé	Rio de Janeiro
Macaé	Rio de Janeiro
Macuco	Rio de Janeiro
Magé	Rio de Janeiro
Mangaratiba	Rio de Janeiro
Maricá	Rio de Janeiro
Mendes	Rio de Janeiro
Mesquita	Rio de Janeiro
Miguel Pereira	Rio de Janeiro
Miracema	Rio de Janeiro
Natividade	Rio de Janeiro
Nilópolis	Rio de Janeiro
Niterói	Rio de Janeiro
Nova Friburgo	Rio de Janeiro
Nova Iguaçu	Rio de Janeiro
Paracambi	Rio de Janeiro
Paraíba do Sul	Rio de Janeiro
Paraty	Rio de Janeiro
Paty do Alferes	Rio de Janeiro
Petrópolis	Rio de Janeiro
Pinheiral	Rio de Janeiro
Piraí	Rio de Janeiro
Porciúncula	Rio de Janeiro
Porto Real	Rio de Janeiro
Quatis	Rio de Janeiro
Queimados	Rio de Janeiro
Quissamã	Rio de Janeiro
Resende	Rio de Janeiro
Rio Bonito	Rio de Janeiro
Rio Claro	Rio de Janeiro
Rio das Flores	Rio de Janeiro
Rio das Ostras	Rio de Janeiro
Rio de Janeiro	Rio de Janeiro
Santa Maria Madalena	Rio de Janeiro
Santo Antônio de Pádua	Rio de Janeiro
São Fidélis	Rio de Janeiro
São Francisco de Itabapoana	Rio de Janeiro
São Gonçalo	Rio de Janeiro
São João da Barra	Rio de Janeiro
São João de Meriti	Rio de Janeiro
São José de Ubá	Rio de Janeiro
São José do Vale do Rio Preto	Rio de Janeiro
São Pedro da Aldeia	Rio de Janeiro
São Sebastião do Alto	Rio de Janeiro
Sapucaia	Rio de Janeiro
Saquarema	Rio de Janeiro
Seropédica	Rio de Janeiro
Silva Jardim	Rio de Janeiro
Sumidouro	Rio de Janeiro
Tanguá	Rio de Janeiro
Teresópolis	Rio de Janeiro
Trajano de Moraes	Rio de Janeiro
Três Rios	Rio de Janeiro
Valença	Rio de Janeiro
Varre-Sai	Rio de Janeiro
Vassouras	Rio de Janeiro
Volta Redonda	Rio de Janeiro
Adamantina	São Paulo
Adolfo	São Paulo
Aguaí	São Paulo
Águas da Prata	São Paulo
Águas de Lindóia	São Paulo
Águas de Santa Bárbara	São Paulo
Águas de São Pedro	São Paulo
Agudos	São Paulo
Alambari	São Paulo
Alfredo Marcondes	São Paulo
Altair	São Paulo
Altinópolis	São Paulo
Alto Alegre	São Paulo
Alumínio	São Paulo
Álvares Florence	São Paulo
Álvares Machado	São Paulo
Álvaro de Carvalho	São Paulo
Alvinlândia	São Paulo
Americana	São Paulo
Américo Brasiliense	São Paulo
Américo de Campos	São Paulo
Amparo	São Paulo
Analândia	São Paulo
Andradina	São Paulo
Angatuba	São Paulo
Anhembi	São Paulo
Anhumas	São Paulo
Aparecida	São Paulo
Aparecida d'Oeste	São Paulo
Apiaí	São Paulo
Araçariguama	São Paulo
Araçatuba	São Paulo
Araçoiaba da Serra	São Paulo
Aramina	São Paulo
Arandu	São Paulo
Arapeí	São Paulo
Araraquara	São Paulo
Araras	São Paulo
Arco-Íris	São Paulo
Arealva	São Paulo
Areias	São Paulo
Areiópolis	São Paulo
Ariranha	São Paulo
Artur Nogueira	São Paulo
Arujá	São Paulo
Aspásia	São Paulo
Assis	São Paulo
Atibaia	São Paulo
Auriflama	São Paulo
Avaí	São Paulo
Avanhandava	São Paulo
Avaré	São Paulo
Bady Bassitt	São Paulo
Balbinos	São Paulo
Bálsamo	São Paulo
Bananal	São Paulo
Barão de Antonina	São Paulo
Barbosa	São Paulo
Bariri	São Paulo
Barra Bonita	São Paulo
Barra do Chapéu	São Paulo
Barra do Turvo	São Paulo
Barretos	São Paulo
Barrinha	São Paulo
Barueri	São Paulo
Bastos	São Paulo
Batatais	São Paulo
Bauru	São Paulo
Bebedouro	São Paulo
Bento de Abreu	São Paulo
Bernardino de Campos	São Paulo
Bertioga	São Paulo
Bilac	São Paulo
Birigui	São Paulo
Biritiba Mirim	São Paulo
Boa Esperança do Sul	São Paulo
Bocaina	São Paulo
Bofete	São Paulo
Boituva	São Paulo
Bom Jesus dos Perdões	São Paulo
Bom Sucesso de Itararé	São Paulo
Borá	São Paulo
Boracéia	São Paulo
Borborema	São Paulo
Borebi	São Paulo
Botucatu	São Paulo
Bragança Paulista	São Paulo
Braúna	São Paulo
Brejo Alegre	São Paulo
Brodowski	São Paulo
Brotas	São Paulo
Buri	São Paulo
Buritama	São Paulo
Buritizal	São Paulo
Cabrália Paulista	São Paulo
Cabreúva	São Paulo
Caçapava	São Paulo
Cachoeira Paulista	São Paulo
Caconde	São Paulo
Cafelândia	São Paulo
Caiabu	São Paulo
Caieiras	São Paulo
Caiuá	São Paulo
Cajamar	São Paulo
Cajati	São Paulo
Cajobi	São Paulo
Cajuru	São Paulo
Campina do Monte Alegre	São Paulo
Campinas	São Paulo
Campo Limpo Paulista	São Paulo
Campos do Jordão	São Paulo
Campos Novos Paulista	São Paulo
Cananéia	São Paulo
Canas	São Paulo
Cândido Mota	São Paulo
Cândido Rodrigues	São Paulo
Canitar	São Paulo
Capão Bonito	São Paulo
Capela do Alto	São Paulo
Capivari	São Paulo
Caraguatatuba	São Paulo
Carapicuíba	São Paulo
Cardoso	São Paulo
Casa Branca	São Paulo
Cássia dos Coqueiros	São Paulo
Castilho	São Paulo
Catanduva	São Paulo
Catiguá	São Paulo
Cedral	São Paulo
Cerqueira César	São Paulo
Cerquilho	São Paulo
Cesário Lange	São Paulo
Charqueada	São Paulo
Chavantes	São Paulo
Clementina	São Paulo
Colina	São Paulo
Colômbia	São Paulo
Conchal	São Paulo
Conchas	São Paulo
Cordeirópolis	São Paulo
Coroados	São Paulo
Coronel Macedo	São Paulo
Corumbataí	São Paulo
Cosmópolis	São Paulo
Cosmorama	São Paulo
Cotia	São Paulo
Cravinhos	São Paulo
Cristais Paulista	São Paulo
Cruzália	São Paulo
Cruzeiro	São Paulo
Cubatão	São Paulo
Cunha	São Paulo
Descalvado	São Paulo
Diadema	São Paulo
Dirce Reis	São Paulo
Divinolândia	São Paulo
Dobrada	São Paulo
Dois Córregos	São Paulo
Dolcinópolis	São Paulo
Dourado	São Paulo
Dracena	São Paulo
Duartina	São Paulo
Dumont	São Paulo
Echaporã	São Paulo
Eldorado	São Paulo
Elias Fausto	São Paulo
Elisiário	São Paulo
Embaúba	São Paulo
Embu das Artes	São Paulo
Embu-Guaçu	São Paulo
Emilianópolis	São Paulo
Engenheiro Coelho	São Paulo
Espírito Santo do Pinhal	São Paulo
Espírito Santo do Turvo	São Paulo
Estiva Gerbi	São Paulo
Estrela do Norte	São Paulo
Estrela d'Oeste	São Paulo
Euclides da Cunha Paulista	São Paulo
Fartura	São Paulo
Fernando Prestes	São Paulo
Fernandópolis	São Paulo
Fernão	São Paulo
Ferraz de Vasconcelos	São Paulo
Flora Rica	São Paulo
Floreal	São Paulo
Flórida Paulista	São Paulo
Florínea	São Paulo
Franca	São Paulo
Francisco Morato	São Paulo
Franco da Rocha	São Paulo
Gabriel Monteiro	São Paulo
Gália	São Paulo
Garça	São Paulo
Gastão Vidigal	São Paulo
Gavião Peixoto	São Paulo
General Salgado	São Paulo
Getulina	São Paulo
Glicério	São Paulo
Guaiçara	São Paulo
Guaimbê	São Paulo
Guaíra	São Paulo
Guapiaçu	São Paulo
Guapiara	São Paulo
Guará	São Paulo
Guaraçaí	São Paulo
Guaraci	São Paulo
Guarani d'Oeste	São Paulo
Guarantã	São Paulo
Guararapes	São Paulo
Guararema	São Paulo
Guaratinguetá	São Paulo
Guareí	São Paulo
Guariba	São Paulo
Guarujá	São Paulo
Guarulhos	São Paulo
Guatapará	São Paulo
Guzolândia	São Paulo
Herculândia	São Paulo
Holambra	São Paulo
Hortolândia	São Paulo
Iacanga	São Paulo
Iacri	São Paulo
Iaras	São Paulo
Ibaté	São Paulo
Ibirá	São Paulo
Ibirarema	São Paulo
Ibitinga	São Paulo
Ibiúna	São Paulo
Icém	São Paulo
Iepê	São Paulo
Igaraçu do Tietê	São Paulo
Igarapava	São Paulo
Igaratá	São Paulo
Iguape	São Paulo
Ilha Comprida	São Paulo
Ilha Solteira	São Paulo
Ilhabela	São Paulo
Indaiatuba	São Paulo
Indiana	São Paulo
Indiaporã	São Paulo
Inúbia Paulista	São Paulo
Ipaussu	São Paulo
Iperó	São Paulo
Ipeúna	São Paulo
Ipiguá	São Paulo
Iporanga	São Paulo
Ipuã	São Paulo
Iracemápolis	São Paulo
Irapuã	São Paulo
Irapuru	São Paulo
Itaberá	São Paulo
Itaí	São Paulo
Itajobi	São Paulo
Itaju	São Paulo
Itanhaém	São Paulo
Itaoca	São Paulo
Itapecerica da Serra	São Paulo
Itapetininga	São Paulo
Itapeva	São Paulo
Itapevi	São Paulo
Itapira	São Paulo
Itapirapuã Paulista	São Paulo
Itápolis	São Paulo
Itaporanga	São Paulo
Itapuí	São Paulo
Itapura	São Paulo
Itaquaquecetuba	São Paulo
Itararé	São Paulo
Itariri	São Paulo
Itatiba	São Paulo
Itatinga	São Paulo
Itirapina	São Paulo
Itirapuã	São Paulo
Itobi	São Paulo
Itu	São Paulo
Itupeva	São Paulo
Ituverava	São Paulo
Jaborandi	São Paulo
Jaboticabal	São Paulo
Jacareí	São Paulo
Jaci	São Paulo
Jacupiranga	São Paulo
Jaguariúna	São Paulo
Jales	São Paulo
Jambeiro	São Paulo
Jandira	São Paulo
Jardinópolis	São Paulo
Jarinu	São Paulo
Jaú	São Paulo
Jeriquara	São Paulo
Joanópolis	São Paulo
João Ramalho	São Paulo
José Bonifácio	São Paulo
Júlio Mesquita	São Paulo
Jumirim	São Paulo
Jundiaí	São Paulo
Junqueirópolis	São Paulo
Juquiá	São Paulo
Juquitiba	São Paulo
Lagoinha	São Paulo
Laranjal Paulista	São Paulo
Lavínia	São Paulo
Lavrinhas	São Paulo
Leme	São Paulo
Lençóis Paulista	São Paulo
Limeira	São Paulo
Lindóia	São Paulo
Lins	São Paulo
Lorena	São Paulo
Lourdes	São Paulo
Louveira	São Paulo
Lucélia	São Paulo
Lucianópolis	São Paulo
Luís Antônio	São Paulo
Luiziânia	São Paulo
Lupércio	São Paulo
Lutécia	São Paulo
Macatuba	São Paulo
Macaubal	São Paulo
Macedônia	São Paulo
Magda	São Paulo
Mairinque	São Paulo
Mairiporã	São Paulo
Manduri	São Paulo
Marabá Paulista	São Paulo
Maracaí	São Paulo
Marapoama	São Paulo
Mariápolis	São Paulo
Marília	São Paulo
Marinópolis	São Paulo
Martinópolis	São Paulo
Matão	São Paulo
Mauá	São Paulo
Mendonça	São Paulo
Meridiano	São Paulo
Mesópolis	São Paulo
Miguelópolis	São Paulo
Mineiros do Tietê	São Paulo
Mira Estrela	São Paulo
Miracatu	São Paulo
Mirandópolis	São Paulo
Mirante do Paranapanema	São Paulo
Mirassol	São Paulo
Mirassolândia	São Paulo
Mococa	São Paulo
Mogi das Cruzes	São Paulo
Mogi Guaçu	São Paulo
Mogi Mirim	São Paulo
Mombuca	São Paulo
Monções	São Paulo
Mongaguá	São Paulo
Monte Alegre do Sul	São Paulo
Monte Alto	São Paulo
Monte Aprazível	São Paulo
Monte Azul Paulista	São Paulo
Monte Castelo	São Paulo
Monte Mor	São Paulo
Monteiro Lobato	São Paulo
Morro Agudo	São Paulo
Morungaba	São Paulo
Motuca	São Paulo
Murutinga do Sul	São Paulo
Nantes	São Paulo
Narandiba	São Paulo
Natividade da Serra	São Paulo
Nazaré Paulista	São Paulo
Neves Paulista	São Paulo
Nhandeara	São Paulo
Nipoã	São Paulo
Nova Aliança	São Paulo
Nova Campina	São Paulo
Nova Canaã Paulista	São Paulo
Nova Castilho	São Paulo
Nova Europa	São Paulo
Nova Granada	São Paulo
Nova Guataporanga	São Paulo
Nova Independência	São Paulo
Nova Luzitânia	São Paulo
Nova Odessa	São Paulo
Novais	São Paulo
Novo Horizonte	São Paulo
Nuporanga	São Paulo
Ocauçu	São Paulo
Óleo	São Paulo
Olímpia	São Paulo
Onda Verde	São Paulo
Oriente	São Paulo
Orindiúva	São Paulo
Orlândia	São Paulo
Osasco	São Paulo
Oscar Bressane	São Paulo
Osvaldo Cruz	São Paulo
Ourinhos	São Paulo
Ouro Verde	São Paulo
Ouroeste	São Paulo
Pacaembu	São Paulo
Palestina	São Paulo
Palmares Paulista	São Paulo
Palmeira d'Oeste	São Paulo
Palmital	São Paulo
Panorama	São Paulo
Paraguaçu Paulista	São Paulo
Paraibuna	São Paulo
Paraíso	São Paulo
Paranapanema	São Paulo
Paranapuã	São Paulo
Parapuã	São Paulo
Pardinho	São Paulo
Pariquera-Açu	São Paulo
Parisi	São Paulo
Patrocínio Paulista	São Paulo
Paulicéia	São Paulo
Paulínia	São Paulo
Paulistânia	São Paulo
Paulo de Faria	São Paulo
Pederneiras	São Paulo
Pedra Bela	São Paulo
Pedranópolis	São Paulo
Pedregulho	São Paulo
Pedreira	São Paulo
Pedrinhas Paulista	São Paulo
Pedro de Toledo	São Paulo
Penápolis	São Paulo
Pereira Barreto	São Paulo
Pereiras	São Paulo
Peruíbe	São Paulo
Piacatu	São Paulo
Piedade	São Paulo
Pilar do Sul	São Paulo
Pindamonhangaba	São Paulo
Pindorama	São Paulo
Pinhalzinho	São Paulo
Piquerobi	São Paulo
Piquete	São Paulo
Piracaia	São Paulo
Piracicaba	São Paulo
Piraju	São Paulo
Pirajuí	São Paulo
Pirangi	São Paulo
Pirapora do Bom Jesus	São Paulo
Pirapozinho	São Paulo
Pirassununga	São Paulo
Piratininga	São Paulo
Pitangueiras	São Paulo
Planalto	São Paulo
Platina	São Paulo
Poá	São Paulo
Poloni	São Paulo
Pompéia	São Paulo
Pongaí	São Paulo
Pontal	São Paulo
Pontalinda	São Paulo
Pontes Gestal	São Paulo
Populina	São Paulo
Porangaba	São Paulo
Porto Feliz	São Paulo
Porto Ferreira	São Paulo
Potim	São Paulo
Potirendaba	São Paulo
Pracinha	São Paulo
Pradópolis	São Paulo
Praia Grande	São Paulo
Pratânia	São Paulo
Presidente Alves	São Paulo
Presidente Bernardes	São Paulo
Presidente Epitácio	São Paulo
Presidente Prudente	São Paulo
Presidente Venceslau	São Paulo
Promissão	São Paulo
Quadra	São Paulo
Quatá	São Paulo
Queiroz	São Paulo
Queluz	São Paulo
Quintana	São Paulo
Rafard	São Paulo
Rancharia	São Paulo
Redenção da Serra	São Paulo
Regente Feijó	São Paulo
Reginópolis	São Paulo
Registro	São Paulo
Restinga	São Paulo
Ribeira	São Paulo
Ribeirão Bonito	São Paulo
Ribeirão Branco	São Paulo
Ribeirão Corrente	São Paulo
Ribeirão do Sul	São Paulo
Ribeirão dos Índios	São Paulo
Ribeirão Grande	São Paulo
Ribeirão Pires	São Paulo
Ribeirão Preto	São Paulo
Rifaina	São Paulo
Rincão	São Paulo
Rinópolis	São Paulo
Rio Claro	São Paulo
Rio das Pedras	São Paulo
Rio Grande da Serra	São Paulo
Riolândia	São Paulo
Riversul	São Paulo
Rosana	São Paulo
Roseira	São Paulo
Rubiácea	São Paulo
Rubinéia	São Paulo
Sabino	São Paulo
Sagres	São Paulo
Sales	São Paulo
Sales Oliveira	São Paulo
Salesópolis	São Paulo
Salmourão	São Paulo
Saltinho	São Paulo
Salto	São Paulo
Salto de Pirapora	São Paulo
Salto Grande	São Paulo
Sandovalina	São Paulo
Santa Adélia	São Paulo
Santa Albertina	São Paulo
Santa Bárbara d'Oeste	São Paulo
Santa Branca	São Paulo
Santa Clara d'Oeste	São Paulo
Santa Cruz da Conceição	São Paulo
Santa Cruz da Esperança	São Paulo
Santa Cruz das Palmeiras	São Paulo
Santa Cruz do Rio Pardo	São Paulo
Santa Ernestina	São Paulo
Santa Fé do Sul	São Paulo
Santa Gertrudes	São Paulo
Santa Isabel	São Paulo
Santa Lúcia	São Paulo
Santa Maria da Serra	São Paulo
Santa Mercedes	São Paulo
Santa Rita do Passa Quatro	São Paulo
Santa Rita d'Oeste	São Paulo
Santa Rosa de Viterbo	São Paulo
Santa Salete	São Paulo
Santana da Ponte Pensa	São Paulo
Santana de Parnaíba	São Paulo
Santo Anastácio	São Paulo
Santo André	São Paulo
Santo Antônio da Alegria	São Paulo
Santo Antônio de Posse	São Paulo
Santo Antônio do Aracanguá	São Paulo
Santo Antônio do Jardim	São Paulo
Santo Antônio do Pinhal	São Paulo
Santo Expedito	São Paulo
Santópolis do Aguapeí	São Paulo
Santos	São Paulo
São Bento do Sapucaí	São Paulo
São Bernardo do Campo	São Paulo
São Caetano do Sul	São Paulo
São Carlos	São Paulo
São Francisco	São Paulo
São João da Boa Vista	São Paulo
São João das Duas Pontes	São Paulo
São João de Iracema	São Paulo
São João do Pau d'Alho	São Paulo
São Joaquim da Barra	São Paulo
São José da Bela Vista	São Paulo
São José do Barreiro	São Paulo
São José do Rio Pardo	São Paulo
São José do Rio Preto	São Paulo
São José dos Campos	São Paulo
São Lourenço da Serra	São Paulo
São Luiz do Paraitinga	São Paulo
São Manuel	São Paulo
São Miguel Arcanjo	São Paulo
São Paulo	São Paulo
São Pedro	São Paulo
São Pedro do Turvo	São Paulo
São Roque	São Paulo
São Sebastião	São Paulo
São Sebastião da Grama	São Paulo
São Simão	São Paulo
São Vicente	São Paulo
Sarapuí	São Paulo
Sarutaiá	São Paulo
Sebastianópolis do Sul	São Paulo
Serra Azul	São Paulo
Serra Negra	São Paulo
Serrana	São Paulo
Sertãozinho	São Paulo
Sete Barras	São Paulo
Severínia	São Paulo
Silveiras	São Paulo
Socorro	São Paulo
Sorocaba	São Paulo
Sud Mennucci	São Paulo
Sumaré	São Paulo
Suzanápolis	São Paulo
Suzano	São Paulo
Tabapuã	São Paulo
Tabatinga	São Paulo
Taboão da Serra	São Paulo
Taciba	São Paulo
Taguaí	São Paulo
Taiaçu	São Paulo
Taiúva	São Paulo
Tambaú	São Paulo
Tanabi	São Paulo
Tapiraí	São Paulo
Tapiratiba	São Paulo
Taquaral	São Paulo
Taquaritinga	São Paulo
Taquarituba	São Paulo
Taquarivaí	São Paulo
Tarabai	São Paulo
Tarumã	São Paulo
Tatuí	São Paulo
Taubaté	São Paulo
Tejupá	São Paulo
Teodoro Sampaio	São Paulo
Terra Roxa	São Paulo
Tietê	São Paulo
Timburi	São Paulo
Torre de Pedra	São Paulo
Torrinha	São Paulo
Trabiju	São Paulo
Tremembé	São Paulo
Três Fronteiras	São Paulo
Tuiuti	São Paulo
Tupã	São Paulo
Tupi Paulista	São Paulo
Turiúba	São Paulo
Turmalina	São Paulo
Ubarana	São Paulo
Ubatuba	São Paulo
Ubirajara	São Paulo
Uchoa	São Paulo
União Paulista	São Paulo
Urânia	São Paulo
Uru	São Paulo
Urupês	São Paulo
Valentim Gentil	São Paulo
Valinhos	São Paulo
Valparaíso	São Paulo
Vargem	São Paulo
Vargem Grande do Sul	São Paulo
Vargem Grande Paulista	São Paulo
Várzea Paulista	São Paulo
Vera Cruz	São Paulo
Vinhedo	São Paulo
Viradouro	São Paulo
Vista Alegre do Alto	São Paulo
Vitória Brasil	São Paulo
Votorantim	São Paulo
Votuporanga	São Paulo
Zacarias	São Paulo
Abatiá	Paraná
Adrianópolis	Paraná
Agudos do Sul	Paraná
Almirante Tamandaré	Paraná
Altamira do Paraná	Paraná
Alto Paraíso	Paraná
Alto Paraná	Paraná
Alto Piquiri	Paraná
Altônia	Paraná
Alvorada do Sul	Paraná
Amaporã	Paraná
Ampére	Paraná
Anahy	Paraná
Andirá	Paraná
Ângulo	Paraná
Antonina	Paraná
Antônio Olinto	Paraná
Apucarana	Paraná
Arapongas	Paraná
Arapoti	Paraná
Arapuã	Paraná
Araruna	Paraná
Araucária	Paraná
Ariranha do Ivaí	Paraná
Assaí	Paraná
Assis Chateaubriand	Paraná
Astorga	Paraná
Atalaia	Paraná
Balsa Nova	Paraná
Bandeirantes	Paraná
Barbosa Ferraz	Paraná
Barra do Jacaré	Paraná
Barracão	Paraná
Bela Vista da Caroba	Paraná
Bela Vista do Paraíso	Paraná
Bituruna	Paraná
Boa Esperança	Paraná
Boa Esperança do Iguaçu	Paraná
Boa Ventura de São Roque	Paraná
Boa Vista da Aparecida	Paraná
Bocaiúva do Sul	Paraná
Bom Jesus do Sul	Paraná
Bom Sucesso	Paraná
Bom Sucesso do Sul	Paraná
Borrazópolis	Paraná
Braganey	Paraná
Brasilândia do Sul	Paraná
Cafeara	Paraná
Cafelândia	Paraná
Cafezal do Sul	Paraná
Califórnia	Paraná
Cambará	Paraná
Cambé	Paraná
Cambira	Paraná
Campina da Lagoa	Paraná
Campina do Simão	Paraná
Campina Grande do Sul	Paraná
Campo Bonito	Paraná
Campo do Tenente	Paraná
Campo Largo	Paraná
Campo Magro	Paraná
Campo Mourão	Paraná
Cândido de Abreu	Paraná
Candói	Paraná
Cantagalo	Paraná
Capanema	Paraná
Capitão Leônidas Marques	Paraná
Carambeí	Paraná
Carlópolis	Paraná
Cascavel	Paraná
Castro	Paraná
Catanduvas	Paraná
Centenário do Sul	Paraná
Cerro Azul	Paraná
Céu Azul	Paraná
Chopinzinho	Paraná
Cianorte	Paraná
Cidade Gaúcha	Paraná
Clevelândia	Paraná
Colombo	Paraná
Colorado	Paraná
Congonhinhas	Paraná
Conselheiro Mairinck	Paraná
Contenda	Paraná
Corbélia	Paraná
Cornélio Procópio	Paraná
Coronel Domingos Soares	Paraná
Coronel Vivida	Paraná
Corumbataí do Sul	Paraná
Cruz Machado	Paraná
Cruzeiro do Iguaçu	Paraná
Cruzeiro do Oeste	Paraná
Cruzeiro do Sul	Paraná
Cruzmaltina	Paraná
Curitiba	Paraná
Curiúva	Paraná
Diamante do Norte	Paraná
Diamante do Sul	Paraná
Diamante D'Oeste	Paraná
Dois Vizinhos	Paraná
Douradina	Paraná
Doutor Camargo	Paraná
Doutor Ulysses	Paraná
Enéas Marques	Paraná
Engenheiro Beltrão	Paraná
Entre Rios do Oeste	Paraná
Esperança Nova	Paraná
Espigão Alto do Iguaçu	Paraná
Farol	Paraná
Faxinal	Paraná
Fazenda Rio Grande	Paraná
Fênix	Paraná
Fernandes Pinheiro	Paraná
Figueira	Paraná
Flor da Serra do Sul	Paraná
Floraí	Paraná
Floresta	Paraná
Florestópolis	Paraná
Flórida	Paraná
Formosa do Oeste	Paraná
Foz do Iguaçu	Paraná
Foz do Jordão	Paraná
Francisco Alves	Paraná
Francisco Beltrão	Paraná
General Carneiro	Paraná
Godoy Moreira	Paraná
Goioerê	Paraná
Goioxim	Paraná
Grandes Rios	Paraná
Guaíra	Paraná
Guairaçá	Paraná
Guamiranga	Paraná
Guapirama	Paraná
Guaporema	Paraná
Guaraci	Paraná
Guaraniaçu	Paraná
Guarapuava	Paraná
Guaraqueçaba	Paraná
Guaratuba	Paraná
Honório Serpa	Paraná
Ibaiti	Paraná
Ibema	Paraná
Ibiporã	Paraná
Icaraíma	Paraná
Iguaraçu	Paraná
Iguatu	Paraná
Imbaú	Paraná
Imbituva	Paraná
Inácio Martins	Paraná
Inajá	Paraná
Indianópolis	Paraná
Ipiranga	Paraná
Iporã	Paraná
Iracema do Oeste	Paraná
Irati	Paraná
Iretama	Paraná
Itaguajé	Paraná
Itaipulândia	Paraná
Itambaracá	Paraná
Itambé	Paraná
Itapejara d'Oeste	Paraná
Itaperuçu	Paraná
Itaúna do Sul	Paraná
Ivaí	Paraná
Ivaiporã	Paraná
Ivaté	Paraná
Ivatuba	Paraná
Jaboti	Paraná
Jacarezinho	Paraná
Jaguapitã	Paraná
Jaguariaíva	Paraná
Jandaia do Sul	Paraná
Janiópolis	Paraná
Japira	Paraná
Japurá	Paraná
Jardim Alegre	Paraná
Jardim Olinda	Paraná
Jataizinho	Paraná
Jesuítas	Paraná
Joaquim Távora	Paraná
Jundiaí do Sul	Paraná
Juranda	Paraná
Jussara	Paraná
Kaloré	Paraná
Lapa	Paraná
Laranjal	Paraná
Laranjeiras do Sul	Paraná
Leópolis	Paraná
Lidianópolis	Paraná
Lindoeste	Paraná
Loanda	Paraná
Lobato	Paraná
Londrina	Paraná
Luiziana	Paraná
Lunardelli	Paraná
Lupionópolis	Paraná
Mallet	Paraná
Mamborê	Paraná
Mandaguaçu	Paraná
Mandaguari	Paraná
Mandirituba	Paraná
Manfrinópolis	Paraná
Mangueirinha	Paraná
Manoel Ribas	Paraná
Marechal Cândido Rondon	Paraná
Maria Helena	Paraná
Marialva	Paraná
Marilândia do Sul	Paraná
Marilena	Paraná
Mariluz	Paraná
Maringá	Paraná
Mariópolis	Paraná
Maripá	Paraná
Marmeleiro	Paraná
Marquinho	Paraná
Marumbi	Paraná
Matelândia	Paraná
Matinhos	Paraná
Mato Rico	Paraná
Mauá da Serra	Paraná
Medianeira	Paraná
Mercedes	Paraná
Mirador	Paraná
Miraselva	Paraná
Missal	Paraná
Moreira Sales	Paraná
Morretes	Paraná
Munhoz de Melo	Paraná
Nossa Senhora das Graças	Paraná
Nova Aliança do Ivaí	Paraná
Nova América da Colina	Paraná
Nova Aurora	Paraná
Nova Cantu	Paraná
Nova Esperança	Paraná
Nova Esperança do Sudoeste	Paraná
Nova Fátima	Paraná
Nova Laranjeiras	Paraná
Nova Londrina	Paraná
Nova Olímpia	Paraná
Nova Prata do Iguaçu	Paraná
Nova Santa Bárbara	Paraná
Nova Santa Rosa	Paraná
Nova Tebas	Paraná
Novo Itacolomi	Paraná
Ortigueira	Paraná
Ourizona	Paraná
Ouro Verde do Oeste	Paraná
Paiçandu	Paraná
Palmas	Paraná
Palmeira	Paraná
Palmital	Paraná
Palotina	Paraná
Paraíso do Norte	Paraná
Paranacity	Paraná
Paranaguá	Paraná
Paranapoema	Paraná
Paranavaí	Paraná
Pato Bragado	Paraná
Pato Branco	Paraná
Paula Freitas	Paraná
Paulo Frontin	Paraná
Peabiru	Paraná
Perobal	Paraná
Pérola	Paraná
Pérola d'Oeste	Paraná
Piên	Paraná
Pinhais	Paraná
Pinhal de São Bento	Paraná
Pinhalão	Paraná
Pinhão	Paraná
Piraí do Sul	Paraná
Piraquara	Paraná
Pitanga	Paraná
Pitangueiras	Paraná
Planaltina do Paraná	Paraná
Planalto	Paraná
Ponta Grossa	Paraná
Pontal do Paraná	Paraná
Porecatu	Paraná
Porto Amazonas	Paraná
Porto Barreiro	Paraná
Porto Rico	Paraná
Porto Vitória	Paraná
Prado Ferreira	Paraná
Pranchita	Paraná
Presidente Castelo Branco	Paraná
Primeiro de Maio	Paraná
Prudentópolis	Paraná
Quarto Centenário	Paraná
Quatiguá	Paraná
Quatro Barras	Paraná
Quatro Pontes	Paraná
Quedas do Iguaçu	Paraná
Querência do Norte	Paraná
Quinta do Sol	Paraná
Quitandinha	Paraná
Ramilândia	Paraná
Rancho Alegre	Paraná
Rancho Alegre D'Oeste	Paraná
Realeza	Paraná
Rebouças	Paraná
Renascença	Paraná
Reserva	Paraná
Reserva do Iguaçu	Paraná
Ribeirão Claro	Paraná
Ribeirão do Pinhal	Paraná
Rio Azul	Paraná
Rio Bom	Paraná
Rio Bonito do Iguaçu	Paraná
Rio Branco do Ivaí	Paraná
Rio Branco do Sul	Paraná
Rio Negro	Paraná
Rolândia	Paraná
Roncador	Paraná
Rondon	Paraná
Rosário do Ivaí	Paraná
Sabáudia	Paraná
Salgado Filho	Paraná
Salto do Itararé	Paraná
Salto do Lontra	Paraná
Santa Amélia	Paraná
Santa Cecília do Pavão	Paraná
Santa Cruz de Monte Castelo	Paraná
Santa Fé	Paraná
Santa Helena	Paraná
Santa Inês	Paraná
Santa Isabel do Ivaí	Paraná
Santa Izabel do Oeste	Paraná
Santa Lúcia	Paraná
Santa Maria do Oeste	Paraná
Santa Mariana	Paraná
Santa Mônica	Paraná
Santa Tereza do Oeste	Paraná
Santa Terezinha de Itaipu	Paraná
Santana do Itararé	Paraná
Santo Antônio da Platina	Paraná
Santo Antônio do Caiuá	Paraná
Santo Antônio do Paraíso	Paraná
Santo Antônio do Sudoeste	Paraná
Santo Inácio	Paraná
São Carlos do Ivaí	Paraná
São Jerônimo da Serra	Paraná
São João	Paraná
São João do Caiuá	Paraná
São João do Ivaí	Paraná
São João do Triunfo	Paraná
São Jorge do Ivaí	Paraná
São Jorge do Patrocínio	Paraná
São Jorge d'Oeste	Paraná
São José da Boa Vista	Paraná
São José das Palmeiras	Paraná
São José dos Pinhais	Paraná
São Manoel do Paraná	Paraná
São Mateus do Sul	Paraná
São Miguel do Iguaçu	Paraná
São Pedro do Iguaçu	Paraná
São Pedro do Ivaí	Paraná
São Pedro do Paraná	Paraná
São Sebastião da Amoreira	Paraná
São Tomé	Paraná
Sapopema	Paraná
Sarandi	Paraná
Saudade do Iguaçu	Paraná
Sengés	Paraná
Serranópolis do Iguaçu	Paraná
Sertaneja	Paraná
Sertanópolis	Paraná
Siqueira Campos	Paraná
Sulina	Paraná
Tamarana	Paraná
Tamboara	Paraná
Tapejara	Paraná
Tapira	Paraná
Teixeira Soares	Paraná
Telêmaco Borba	Paraná
Terra Boa	Paraná
Terra Rica	Paraná
Terra Roxa	Paraná
Tibagi	Paraná
Tijucas do Sul	Paraná
Toledo	Paraná
Tomazina	Paraná
Três Barras do Paraná	Paraná
Tunas do Paraná	Paraná
Tuneiras do Oeste	Paraná
Tupãssi	Paraná
Turvo	Paraná
Ubiratã	Paraná
Umuarama	Paraná
União da Vitória	Paraná
Uniflor	Paraná
Uraí	Paraná
Ventania	Paraná
Vera Cruz do Oeste	Paraná
Verê	Paraná
Virmond	Paraná
Vitorino	Paraná
Wenceslau Braz	Paraná
Xambrê	Paraná
Abdon Batista	Santa Catarina
Abelardo Luz	Santa Catarina
Agrolândia	Santa Catarina
Agronômica	Santa Catarina
Água Doce	Santa Catarina
Águas de Chapecó	Santa Catarina
Águas Frias	Santa Catarina
Águas Mornas	Santa Catarina
Alfredo Wagner	Santa Catarina
Alto Bela Vista	Santa Catarina
Anchieta	Santa Catarina
Angelina	Santa Catarina
Anita Garibaldi	Santa Catarina
Anitápolis	Santa Catarina
Antônio Carlos	Santa Catarina
Apiúna	Santa Catarina
Arabutã	Santa Catarina
Araquari	Santa Catarina
Araranguá	Santa Catarina
Armazém	Santa Catarina
Arroio Trinta	Santa Catarina
Arvoredo	Santa Catarina
Ascurra	Santa Catarina
Atalanta	Santa Catarina
Aurora	Santa Catarina
Balneário Arroio do Silva	Santa Catarina
Balneário Barra do Sul	Santa Catarina
Balneário Camboriú	Santa Catarina
Balneário Gaivota	Santa Catarina
Balneário Piçarras	Santa Catarina
Balneário Rincão	Santa Catarina
Bandeirante	Santa Catarina
Barra Bonita	Santa Catarina
Barra Velha	Santa Catarina
Bela Vista do Toldo	Santa Catarina
Belmonte	Santa Catarina
Benedito Novo	Santa Catarina
Biguaçu	Santa Catarina
Blumenau	Santa Catarina
Bocaina do Sul	Santa Catarina
Bom Jardim da Serra	Santa Catarina
Bom Jesus	Santa Catarina
Bom Jesus do Oeste	Santa Catarina
Bom Retiro	Santa Catarina
Bombinhas	Santa Catarina
Botuverá	Santa Catarina
Braço do Norte	Santa Catarina
Braço do Trombudo	Santa Catarina
Brunópolis	Santa Catarina
Brusque	Santa Catarina
Caçador	Santa Catarina
Caibi	Santa Catarina
Calmon	Santa Catarina
Camboriú	Santa Catarina
Campo Alegre	Santa Catarina
Campo Belo do Sul	Santa Catarina
Campo Erê	Santa Catarina
Campos Novos	Santa Catarina
Canelinha	Santa Catarina
Canoinhas	Santa Catarina
Capão Alto	Santa Catarina
Capinzal	Santa Catarina
Capivari de Baixo	Santa Catarina
Catanduvas	Santa Catarina
Caxambu do Sul	Santa Catarina
Celso Ramos	Santa Catarina
Cerro Negro	Santa Catarina
Chapadão do Lageado	Santa Catarina
Chapecó	Santa Catarina
Cocal do Sul	Santa Catarina
Concórdia	Santa Catarina
Cordilheira Alta	Santa Catarina
Coronel Freitas	Santa Catarina
Coronel Martins	Santa Catarina
Correia Pinto	Santa Catarina
Corupá	Santa Catarina
Criciúma	Santa Catarina
Cunha Porã	Santa Catarina
Cunhataí	Santa Catarina
Curitibanos	Santa Catarina
Descanso	Santa Catarina
Dionísio Cerqueira	Santa Catarina
Dona Emma	Santa Catarina
Doutor Pedrinho	Santa Catarina
Entre Rios	Santa Catarina
Ermo	Santa Catarina
Erval Velho	Santa Catarina
Faxinal dos Guedes	Santa Catarina
Flor do Sertão	Santa Catarina
Florianópolis	Santa Catarina
Formosa do Sul	Santa Catarina
Forquilhinha	Santa Catarina
Fraiburgo	Santa Catarina
Frei Rogério	Santa Catarina
Galvão	Santa Catarina
Garopaba	Santa Catarina
Garuva	Santa Catarina
Gaspar	Santa Catarina
Governador Celso Ramos	Santa Catarina
Grão Pará	Santa Catarina
Gravatal	Santa Catarina
Guabiruba	Santa Catarina
Guaraciaba	Santa Catarina
Guaramirim	Santa Catarina
Guarujá do Sul	Santa Catarina
Guatambú	Santa Catarina
Herval d'Oeste	Santa Catarina
Ibiam	Santa Catarina
Ibicaré	Santa Catarina
Ibirama	Santa Catarina
Içara	Santa Catarina
Ilhota	Santa Catarina
Imaruí	Santa Catarina
Imbituba	Santa Catarina
Imbuia	Santa Catarina
Indaial	Santa Catarina
Iomerê	Santa Catarina
Ipira	Santa Catarina
Iporã do Oeste	Santa Catarina
Ipuaçu	Santa Catarina
Ipumirim	Santa Catarina
Iraceminha	Santa Catarina
Irani	Santa Catarina
Irati	Santa Catarina
Irineópolis	Santa Catarina
Itá	Santa Catarina
Itaiópolis	Santa Catarina
Itajaí	Santa Catarina
Itapema	Santa Catarina
Itapiranga	Santa Catarina
Itapoá	Santa Catarina
Ituporanga	Santa Catarina
Jaborá	Santa Catarina
Jacinto Machado	Santa Catarina
Jaguaruna	Santa Catarina
Jaraguá do Sul	Santa Catarina
Jardinópolis	Santa Catarina
Joaçaba	Santa Catarina
Joinville	Santa Catarina
José Boiteux	Santa Catarina
Jupiá	Santa Catarina
Lacerdópolis	Santa Catarina
Lages	Santa Catarina
Laguna	Santa Catarina
Lajeado Grande	Santa Catarina
Laurentino	Santa Catarina
Lauro Müller	Santa Catarina
Lebon Régis	Santa Catarina
Leoberto Leal	Santa Catarina
Lindóia do Sul	Santa Catarina
Lontras	Santa Catarina
Luiz Alves	Santa Catarina
Luzerna	Santa Catarina
Macieira	Santa Catarina
Mafra	Santa Catarina
Major Gercino	Santa Catarina
Major Vieira	Santa Catarina
Maracajá	Santa Catarina
Maravilha	Santa Catarina
Marema	Santa Catarina
Massaranduba	Santa Catarina
Matos Costa	Santa Catarina
Meleiro	Santa Catarina
Mirim Doce	Santa Catarina
Modelo	Santa Catarina
Mondaí	Santa Catarina
Monte Carlo	Santa Catarina
Monte Castelo	Santa Catarina
Morro da Fumaça	Santa Catarina
Morro Grande	Santa Catarina
Navegantes	Santa Catarina
Nova Erechim	Santa Catarina
Nova Itaberaba	Santa Catarina
Nova Trento	Santa Catarina
Nova Veneza	Santa Catarina
Novo Horizonte	Santa Catarina
Orleans	Santa Catarina
Otacílio Costa	Santa Catarina
Ouro	Santa Catarina
Ouro Verde	Santa Catarina
Paial	Santa Catarina
Painel	Santa Catarina
Palhoça	Santa Catarina
Palma Sola	Santa Catarina
Palmeira	Santa Catarina
Palmitos	Santa Catarina
Papanduva	Santa Catarina
Paraíso	Santa Catarina
Passo de Torres	Santa Catarina
Passos Maia	Santa Catarina
Paulo Lopes	Santa Catarina
Pedras Grandes	Santa Catarina
Penha	Santa Catarina
Peritiba	Santa Catarina
Pescaria Brava	Santa Catarina
Petrolândia	Santa Catarina
Pinhalzinho	Santa Catarina
Pinheiro Preto	Santa Catarina
Piratuba	Santa Catarina
Planalto Alegre	Santa Catarina
Pomerode	Santa Catarina
Ponte Alta	Santa Catarina
Ponte Alta do Norte	Santa Catarina
Ponte Serrada	Santa Catarina
Porto Belo	Santa Catarina
Porto União	Santa Catarina
Pouso Redondo	Santa Catarina
Praia Grande	Santa Catarina
Presidente Castello Branco	Santa Catarina
Presidente Getúlio	Santa Catarina
Presidente Nereu	Santa Catarina
Princesa	Santa Catarina
Quilombo	Santa Catarina
Rancho Queimado	Santa Catarina
Rio das Antas	Santa Catarina
Rio do Campo	Santa Catarina
Rio do Oeste	Santa Catarina
Rio do Sul	Santa Catarina
Rio dos Cedros	Santa Catarina
Rio Fortuna	Santa Catarina
Rio Negrinho	Santa Catarina
Rio Rufino	Santa Catarina
Riqueza	Santa Catarina
Rodeio	Santa Catarina
Romelândia	Santa Catarina
Salete	Santa Catarina
Saltinho	Santa Catarina
Salto Veloso	Santa Catarina
Sangão	Santa Catarina
Santa Cecília	Santa Catarina
Santa Helena	Santa Catarina
Santa Rosa de Lima	Santa Catarina
Santa Rosa do Sul	Santa Catarina
Santa Terezinha	Santa Catarina
Santa Terezinha do Progresso	Santa Catarina
Santiago do Sul	Santa Catarina
Santo Amaro da Imperatriz	Santa Catarina
São Bento do Sul	Santa Catarina
São Bernardino	Santa Catarina
São Bonifácio	Santa Catarina
São Carlos	Santa Catarina
São Cristóvão do Sul	Santa Catarina
São Domingos	Santa Catarina
São Francisco do Sul	Santa Catarina
São João Batista	Santa Catarina
São João do Itaperiú	Santa Catarina
São João do Oeste	Santa Catarina
São João do Sul	Santa Catarina
São Joaquim	Santa Catarina
São José	Santa Catarina
São José do Cedro	Santa Catarina
São José do Cerrito	Santa Catarina
São Lourenço do Oeste	Santa Catarina
São Ludgero	Santa Catarina
São Martinho	Santa Catarina
São Miguel da Boa Vista	Santa Catarina
São Miguel do Oeste	Santa Catarina
São Pedro de Alcântara	Santa Catarina
Saudades	Santa Catarina
Schroeder	Santa Catarina
Seara	Santa Catarina
Serra Alta	Santa Catarina
Siderópolis	Santa Catarina
Sombrio	Santa Catarina
Sul Brasil	Santa Catarina
Taió	Santa Catarina
Tangará	Santa Catarina
Tigrinhos	Santa Catarina
Tijucas	Santa Catarina
Timbé do Sul	Santa Catarina
Timbó	Santa Catarina
Timbó Grande	Santa Catarina
Três Barras	Santa Catarina
Treviso	Santa Catarina
Treze de Maio	Santa Catarina
Treze Tílias	Santa Catarina
Trombudo Central	Santa Catarina
Tubarão	Santa Catarina
Tunápolis	Santa Catarina
Turvo	Santa Catarina
União do Oeste	Santa Catarina
Urubici	Santa Catarina
Urupema	Santa Catarina
Urussanga	Santa Catarina
Vargeão	Santa Catarina
Vargem	Santa Catarina
Vargem Bonita	Santa Catarina
Vidal Ramos	Santa Catarina
Videira	Santa Catarina
Vitor Meireles	Santa Catarina
Witmarsum	Santa Catarina
Xanxerê	Santa Catarina
Xavantina	Santa Catarina
Xaxim	Santa Catarina
Zortéa	Santa Catarina
Aceguá	Rio Grande do Sul
Água Santa	Rio Grande do Sul
Agudo	Rio Grande do Sul
Ajuricaba	Rio Grande do Sul
Alecrim	Rio Grande do Sul
Alegrete	Rio Grande do Sul
Alegria	Rio Grande do Sul
Almirante Tamandaré do Sul	Rio Grande do Sul
Alpestre	Rio Grande do Sul
Alto Alegre	Rio Grande do Sul
Alto Feliz	Rio Grande do Sul
Alvorada	Rio Grande do Sul
Amaral Ferrador	Rio Grande do Sul
Ametista do Sul	Rio Grande do Sul
André da Rocha	Rio Grande do Sul
Anta Gorda	Rio Grande do Sul
Antônio Prado	Rio Grande do Sul
Arambaré	Rio Grande do Sul
Araricá	Rio Grande do Sul
Aratiba	Rio Grande do Sul
Arroio do Meio	Rio Grande do Sul
Arroio do Padre	Rio Grande do Sul
Arroio do Sal	Rio Grande do Sul
Arroio do Tigre	Rio Grande do Sul
Arroio dos Ratos	Rio Grande do Sul
Arroio Grande	Rio Grande do Sul
Arvorezinha	Rio Grande do Sul
Augusto Pestana	Rio Grande do Sul
Áurea	Rio Grande do Sul
Bagé	Rio Grande do Sul
Balneário Pinhal	Rio Grande do Sul
Barão	Rio Grande do Sul
Barão de Cotegipe	Rio Grande do Sul
Barão do Triunfo	Rio Grande do Sul
Barra do Guarita	Rio Grande do Sul
Barra do Quaraí	Rio Grande do Sul
Barra do Ribeiro	Rio Grande do Sul
Barra do Rio Azul	Rio Grande do Sul
Barra Funda	Rio Grande do Sul
Barracão	Rio Grande do Sul
Barros Cassal	Rio Grande do Sul
Benjamin Constant do Sul	Rio Grande do Sul
Bento Gonçalves	Rio Grande do Sul
Boa Vista das Missões	Rio Grande do Sul
Boa Vista do Buricá	Rio Grande do Sul
Boa Vista do Cadeado	Rio Grande do Sul
Boa Vista do Incra	Rio Grande do Sul
Boa Vista do Sul	Rio Grande do Sul
Bom Jesus	Rio Grande do Sul
Bom Princípio	Rio Grande do Sul
Bom Progresso	Rio Grande do Sul
Bom Retiro do Sul	Rio Grande do Sul
Boqueirão do Leão	Rio Grande do Sul
Bossoroca	Rio Grande do Sul
Bozano	Rio Grande do Sul
Braga	Rio Grande do Sul
Brochier	Rio Grande do Sul
Butiá	Rio Grande do Sul
Caçapava do Sul	Rio Grande do Sul
Cacequi	Rio Grande do Sul
Cachoeira do Sul	Rio Grande do Sul
Cachoeirinha	Rio Grande do Sul
Cacique Doble	Rio Grande do Sul
Caibaté	Rio Grande do Sul
Caiçara	Rio Grande do Sul
Camaquã	Rio Grande do Sul
Camargo	Rio Grande do Sul
Cambará do Sul	Rio Grande do Sul
Campestre da Serra	Rio Grande do Sul
Campina das Missões	Rio Grande do Sul
Campinas do Sul	Rio Grande do Sul
Campo Bom	Rio Grande do Sul
Campo Novo	Rio Grande do Sul
Campos Borges	Rio Grande do Sul
Candelária	Rio Grande do Sul
Cândido Godói	Rio Grande do Sul
Candiota	Rio Grande do Sul
Canela	Rio Grande do Sul
Canguçu	Rio Grande do Sul
Canoas	Rio Grande do Sul
Canudos do Vale	Rio Grande do Sul
Capão Bonito do Sul	Rio Grande do Sul
Capão da Canoa	Rio Grande do Sul
Capão do Cipó	Rio Grande do Sul
Capão do Leão	Rio Grande do Sul
Capela de Santana	Rio Grande do Sul
Capitão	Rio Grande do Sul
Capivari do Sul	Rio Grande do Sul
Caraá	Rio Grande do Sul
Carazinho	Rio Grande do Sul
Carlos Barbosa	Rio Grande do Sul
Carlos Gomes	Rio Grande do Sul
Casca	Rio Grande do Sul
Caseiros	Rio Grande do Sul
Catuípe	Rio Grande do Sul
Caxias do Sul	Rio Grande do Sul
Centenário	Rio Grande do Sul
Cerrito	Rio Grande do Sul
Cerro Branco	Rio Grande do Sul
Cerro Grande	Rio Grande do Sul
Cerro Grande do Sul	Rio Grande do Sul
Cerro Largo	Rio Grande do Sul
Chapada	Rio Grande do Sul
Charqueadas	Rio Grande do Sul
Charrua	Rio Grande do Sul
Chiapetta	Rio Grande do Sul
Chuí	Rio Grande do Sul
Chuvisca	Rio Grande do Sul
Cidreira	Rio Grande do Sul
Ciríaco	Rio Grande do Sul
Colinas	Rio Grande do Sul
Colorado	Rio Grande do Sul
Condor	Rio Grande do Sul
Constantina	Rio Grande do Sul
Coqueiro Baixo	Rio Grande do Sul
Coqueiros do Sul	Rio Grande do Sul
Coronel Barros	Rio Grande do Sul
Coronel Bicaco	Rio Grande do Sul
Coronel Pilar	Rio Grande do Sul
Cotiporã	Rio Grande do Sul
Coxilha	Rio Grande do Sul
Crissiumal	Rio Grande do Sul
Cristal	Rio Grande do Sul
Cristal do Sul	Rio Grande do Sul
Cruz Alta	Rio Grande do Sul
Cruzaltense	Rio Grande do Sul
Cruzeiro do Sul	Rio Grande do Sul
David Canabarro	Rio Grande do Sul
Derrubadas	Rio Grande do Sul
Dezesseis de Novembro	Rio Grande do Sul
Dilermando de Aguiar	Rio Grande do Sul
Dois Irmãos	Rio Grande do Sul
Dois Irmãos das Missões	Rio Grande do Sul
Dois Lajeados	Rio Grande do Sul
Dom Feliciano	Rio Grande do Sul
Dom Pedrito	Rio Grande do Sul
Dom Pedro de Alcântara	Rio Grande do Sul
Dona Francisca	Rio Grande do Sul
Doutor Maurício Cardoso	Rio Grande do Sul
Doutor Ricardo	Rio Grande do Sul
Eldorado do Sul	Rio Grande do Sul
Encantado	Rio Grande do Sul
Encruzilhada do Sul	Rio Grande do Sul
Engenho Velho	Rio Grande do Sul
Entre Rios do Sul	Rio Grande do Sul
Entre-Ijuís	Rio Grande do Sul
Erebango	Rio Grande do Sul
Erechim	Rio Grande do Sul
Ernestina	Rio Grande do Sul
Erval Grande	Rio Grande do Sul
Erval Seco	Rio Grande do Sul
Esmeralda	Rio Grande do Sul
Esperança do Sul	Rio Grande do Sul
Espumoso	Rio Grande do Sul
Estação	Rio Grande do Sul
Estância Velha	Rio Grande do Sul
Esteio	Rio Grande do Sul
Estrela	Rio Grande do Sul
Estrela Velha	Rio Grande do Sul
Eugênio de Castro	Rio Grande do Sul
Fagundes Varela	Rio Grande do Sul
Farroupilha	Rio Grande do Sul
Faxinal do Soturno	Rio Grande do Sul
Faxinalzinho	Rio Grande do Sul
Fazenda Vilanova	Rio Grande do Sul
Feliz	Rio Grande do Sul
Flores da Cunha	Rio Grande do Sul
Floriano Peixoto	Rio Grande do Sul
Fontoura Xavier	Rio Grande do Sul
Formigueiro	Rio Grande do Sul
Forquetinha	Rio Grande do Sul
Fortaleza dos Valos	Rio Grande do Sul
Frederico Westphalen	Rio Grande do Sul
Garibaldi	Rio Grande do Sul
Garruchos	Rio Grande do Sul
Gaurama	Rio Grande do Sul
General Câmara	Rio Grande do Sul
Gentil	Rio Grande do Sul
Getúlio Vargas	Rio Grande do Sul
Giruá	Rio Grande do Sul
Glorinha	Rio Grande do Sul
Gramado	Rio Grande do Sul
Gramado dos Loureiros	Rio Grande do Sul
Gramado Xavier	Rio Grande do Sul
Gravataí	Rio Grande do Sul
Guabiju	Rio Grande do Sul
Guaíba	Rio Grande do Sul
Guaporé	Rio Grande do Sul
Guarani das Missões	Rio Grande do Sul
Harmonia	Rio Grande do Sul
Herval	Rio Grande do Sul
Herveiras	Rio Grande do Sul
Horizontina	Rio Grande do Sul
Hulha Negra	Rio Grande do Sul
Humaitá	Rio Grande do Sul
Ibarama	Rio Grande do Sul
Ibiaçá	Rio Grande do Sul
Ibiraiaras	Rio Grande do Sul
Ibirapuitã	Rio Grande do Sul
Ibirubá	Rio Grande do Sul
Igrejinha	Rio Grande do Sul
Ijuí	Rio Grande do Sul
Ilópolis	Rio Grande do Sul
Imbé	Rio Grande do Sul
Imigrante	Rio Grande do Sul
Independência	Rio Grande do Sul
Inhacorá	Rio Grande do Sul
Ipê	Rio Grande do Sul
Ipiranga do Sul	Rio Grande do Sul
Iraí	Rio Grande do Sul
Itaara	Rio Grande do Sul
Itacurubi	Rio Grande do Sul
Itapuca	Rio Grande do Sul
Itaqui	Rio Grande do Sul
Itati	Rio Grande do Sul
Itatiba do Sul	Rio Grande do Sul
Ivorá	Rio Grande do Sul
Ivoti	Rio Grande do Sul
Jaboticaba	Rio Grande do Sul
Jacuizinho	Rio Grande do Sul
Jacutinga	Rio Grande do Sul
Jaguarão	Rio Grande do Sul
Jaguari	Rio Grande do Sul
Jaquirana	Rio Grande do Sul
Jari	Rio Grande do Sul
Jóia	Rio Grande do Sul
Júlio de Castilhos	Rio Grande do Sul
Lagoa Bonita do Sul	Rio Grande do Sul
Lagoa dos Três Cantos	Rio Grande do Sul
Lagoa Vermelha	Rio Grande do Sul
Lagoão	Rio Grande do Sul
Lajeado	Rio Grande do Sul
Lajeado do Bugre	Rio Grande do Sul
Lavras do Sul	Rio Grande do Sul
Liberato Salzano	Rio Grande do Sul
Lindolfo Collor	Rio Grande do Sul
Linha Nova	Rio Grande do Sul
Maçambará	Rio Grande do Sul
Machadinho	Rio Grande do Sul
Mampituba	Rio Grande do Sul
Manoel Viana	Rio Grande do Sul
Maquiné	Rio Grande do Sul
Maratá	Rio Grande do Sul
Marau	Rio Grande do Sul
Marcelino Ramos	Rio Grande do Sul
Mariana Pimentel	Rio Grande do Sul
Mariano Moro	Rio Grande do Sul
Marques de Souza	Rio Grande do Sul
Mata	Rio Grande do Sul
Mato Castelhano	Rio Grande do Sul
Mato Leitão	Rio Grande do Sul
Mato Queimado	Rio Grande do Sul
Maximiliano de Almeida	Rio Grande do Sul
Minas do Leão	Rio Grande do Sul
Miraguaí	Rio Grande do Sul
Montauri	Rio Grande do Sul
Monte Alegre dos Campos	Rio Grande do Sul
Monte Belo do Sul	Rio Grande do Sul
Montenegro	Rio Grande do Sul
Mormaço	Rio Grande do Sul
Morrinhos do Sul	Rio Grande do Sul
Morro Redondo	Rio Grande do Sul
Morro Reuter	Rio Grande do Sul
Mostardas	Rio Grande do Sul
Muçum	Rio Grande do Sul
Muitos Capões	Rio Grande do Sul
Muliterno	Rio Grande do Sul
Não-Me-Toque	Rio Grande do Sul
Nicolau Vergueiro	Rio Grande do Sul
Nonoai	Rio Grande do Sul
Nova Alvorada	Rio Grande do Sul
Nova Araçá	Rio Grande do Sul
Nova Bassano	Rio Grande do Sul
Nova Boa Vista	Rio Grande do Sul
Nova Bréscia	Rio Grande do Sul
Nova Candelária	Rio Grande do Sul
Nova Esperança do Sul	Rio Grande do Sul
Nova Hartz	Rio Grande do Sul
Nova Pádua	Rio Grande do Sul
Nova Palma	Rio Grande do Sul
Nova Petrópolis	Rio Grande do Sul
Nova Prata	Rio Grande do Sul
Nova Ramada	Rio Grande do Sul
Nova Roma do Sul	Rio Grande do Sul
Nova Santa Rita	Rio Grande do Sul
Novo Barreiro	Rio Grande do Sul
Novo Cabrais	Rio Grande do Sul
Novo Hamburgo	Rio Grande do Sul
Novo Machado	Rio Grande do Sul
Novo Tiradentes	Rio Grande do Sul
Novo Xingu	Rio Grande do Sul
Osório	Rio Grande do Sul
Paim Filho	Rio Grande do Sul
Palmares do Sul	Rio Grande do Sul
Palmeira das Missões	Rio Grande do Sul
Palmitinho	Rio Grande do Sul
Panambi	Rio Grande do Sul
Pantano Grande	Rio Grande do Sul
Paraí	Rio Grande do Sul
Paraíso do Sul	Rio Grande do Sul
Pareci Novo	Rio Grande do Sul
Parobé	Rio Grande do Sul
Passa Sete	Rio Grande do Sul
Passo do Sobrado	Rio Grande do Sul
Passo Fundo	Rio Grande do Sul
Paulo Bento	Rio Grande do Sul
Paverama	Rio Grande do Sul
Pedras Altas	Rio Grande do Sul
Pedro Osório	Rio Grande do Sul
Pejuçara	Rio Grande do Sul
Pelotas	Rio Grande do Sul
Picada Café	Rio Grande do Sul
Pinhal	Rio Grande do Sul
Pinhal da Serra	Rio Grande do Sul
Pinhal Grande	Rio Grande do Sul
Pinheirinho do Vale	Rio Grande do Sul
Pinheiro Machado	Rio Grande do Sul
Pinto Bandeira	Rio Grande do Sul
Pirapó	Rio Grande do Sul
Piratini	Rio Grande do Sul
Planalto	Rio Grande do Sul
Poço das Antas	Rio Grande do Sul
Pontão	Rio Grande do Sul
Ponte Preta	Rio Grande do Sul
Portão	Rio Grande do Sul
Porto Alegre	Rio Grande do Sul
Porto Lucena	Rio Grande do Sul
Porto Mauá	Rio Grande do Sul
Porto Vera Cruz	Rio Grande do Sul
Porto Xavier	Rio Grande do Sul
Pouso Novo	Rio Grande do Sul
Presidente Lucena	Rio Grande do Sul
Progresso	Rio Grande do Sul
Protásio Alves	Rio Grande do Sul
Putinga	Rio Grande do Sul
Quaraí	Rio Grande do Sul
Quatro Irmãos	Rio Grande do Sul
Quevedos	Rio Grande do Sul
Quinze de Novembro	Rio Grande do Sul
Redentora	Rio Grande do Sul
Relvado	Rio Grande do Sul
Restinga Sêca	Rio Grande do Sul
Rio dos Índios	Rio Grande do Sul
Rio Grande	Rio Grande do Sul
Rio Pardo	Rio Grande do Sul
Riozinho	Rio Grande do Sul
Roca Sales	Rio Grande do Sul
Rodeio Bonito	Rio Grande do Sul
Rolador	Rio Grande do Sul
Rolante	Rio Grande do Sul
Ronda Alta	Rio Grande do Sul
Rondinha	Rio Grande do Sul
Roque Gonzales	Rio Grande do Sul
Rosário do Sul	Rio Grande do Sul
Sagrada Família	Rio Grande do Sul
Saldanha Marinho	Rio Grande do Sul
Salto do Jacuí	Rio Grande do Sul
Salvador das Missões	Rio Grande do Sul
Salvador do Sul	Rio Grande do Sul
Sananduva	Rio Grande do Sul
Santa Bárbara do Sul	Rio Grande do Sul
Santa Cecília do Sul	Rio Grande do Sul
Santa Clara do Sul	Rio Grande do Sul
Santa Cruz do Sul	Rio Grande do Sul
Santa Margarida do Sul	Rio Grande do Sul
Santa Maria	Rio Grande do Sul
Santa Maria do Herval	Rio Grande do Sul
Santa Rosa	Rio Grande do Sul
Santa Tereza	Rio Grande do Sul
Santa Vitória do Palmar	Rio Grande do Sul
Santana da Boa Vista	Rio Grande do Sul
Sant'Ana do Livramento	Rio Grande do Sul
Santiago	Rio Grande do Sul
Santo Ângelo	Rio Grande do Sul
Santo Antônio da Patrulha	Rio Grande do Sul
Santo Antônio das Missões	Rio Grande do Sul
Santo Antônio do Palma	Rio Grande do Sul
Santo Antônio do Planalto	Rio Grande do Sul
Santo Augusto	Rio Grande do Sul
Santo Cristo	Rio Grande do Sul
Santo Expedito do Sul	Rio Grande do Sul
São Borja	Rio Grande do Sul
São Domingos do Sul	Rio Grande do Sul
São Francisco de Assis	Rio Grande do Sul
São Francisco de Paula	Rio Grande do Sul
São Gabriel	Rio Grande do Sul
São Jerônimo	Rio Grande do Sul
São João da Urtiga	Rio Grande do Sul
São João do Polêsine	Rio Grande do Sul
São Jorge	Rio Grande do Sul
São José das Missões	Rio Grande do Sul
São José do Herval	Rio Grande do Sul
São José do Hortêncio	Rio Grande do Sul
São José do Inhacorá	Rio Grande do Sul
São José do Norte	Rio Grande do Sul
São José do Ouro	Rio Grande do Sul
São José do Sul	Rio Grande do Sul
São José dos Ausentes	Rio Grande do Sul
São Leopoldo	Rio Grande do Sul
São Lourenço do Sul	Rio Grande do Sul
São Luiz Gonzaga	Rio Grande do Sul
São Marcos	Rio Grande do Sul
São Martinho	Rio Grande do Sul
São Martinho da Serra	Rio Grande do Sul
São Miguel das Missões	Rio Grande do Sul
São Nicolau	Rio Grande do Sul
São Paulo das Missões	Rio Grande do Sul
São Pedro da Serra	Rio Grande do Sul
São Pedro das Missões	Rio Grande do Sul
São Pedro do Butiá	Rio Grande do Sul
São Pedro do Sul	Rio Grande do Sul
São Sebastião do Caí	Rio Grande do Sul
São Sepé	Rio Grande do Sul
São Valentim	Rio Grande do Sul
São Valentim do Sul	Rio Grande do Sul
São Valério do Sul	Rio Grande do Sul
São Vendelino	Rio Grande do Sul
São Vicente do Sul	Rio Grande do Sul
Sapiranga	Rio Grande do Sul
Sapucaia do Sul	Rio Grande do Sul
Sarandi	Rio Grande do Sul
Seberi	Rio Grande do Sul
Sede Nova	Rio Grande do Sul
Segredo	Rio Grande do Sul
Selbach	Rio Grande do Sul
Senador Salgado Filho	Rio Grande do Sul
Sentinela do Sul	Rio Grande do Sul
Serafina Corrêa	Rio Grande do Sul
Sério	Rio Grande do Sul
Sertão	Rio Grande do Sul
Sertão Santana	Rio Grande do Sul
Sete de Setembro	Rio Grande do Sul
Severiano de Almeida	Rio Grande do Sul
Silveira Martins	Rio Grande do Sul
Sinimbu	Rio Grande do Sul
Sobradinho	Rio Grande do Sul
Soledade	Rio Grande do Sul
Tabaí	Rio Grande do Sul
Tapejara	Rio Grande do Sul
Tapera	Rio Grande do Sul
Tapes	Rio Grande do Sul
Taquara	Rio Grande do Sul
Taquari	Rio Grande do Sul
Taquaruçu do Sul	Rio Grande do Sul
Tavares	Rio Grande do Sul
Tenente Portela	Rio Grande do Sul
Terra de Areia	Rio Grande do Sul
Teutônia	Rio Grande do Sul
Tio Hugo	Rio Grande do Sul
Tiradentes do Sul	Rio Grande do Sul
Toropi	Rio Grande do Sul
Torres	Rio Grande do Sul
Tramandaí	Rio Grande do Sul
Travesseiro	Rio Grande do Sul
Três Arroios	Rio Grande do Sul
Três Cachoeiras	Rio Grande do Sul
Três Coroas	Rio Grande do Sul
Três de Maio	Rio Grande do Sul
Três Forquilhas	Rio Grande do Sul
Três Palmeiras	Rio Grande do Sul
Três Passos	Rio Grande do Sul
Trindade do Sul	Rio Grande do Sul
Triunfo	Rio Grande do Sul
Tucunduva	Rio Grande do Sul
Tunas	Rio Grande do Sul
Tupanci do Sul	Rio Grande do Sul
Tupanciretã	Rio Grande do Sul
Tupandi	Rio Grande do Sul
Tuparendi	Rio Grande do Sul
Turuçu	Rio Grande do Sul
Ubiretama	Rio Grande do Sul
União da Serra	Rio Grande do Sul
Unistalda	Rio Grande do Sul
Uruguaiana	Rio Grande do Sul
Vacaria	Rio Grande do Sul
Vale do Sol	Rio Grande do Sul
Vale Real	Rio Grande do Sul
Vale Verde	Rio Grande do Sul
Vanini	Rio Grande do Sul
Venâncio Aires	Rio Grande do Sul
Vera Cruz	Rio Grande do Sul
Veranópolis	Rio Grande do Sul
Vespasiano Corrêa	Rio Grande do Sul
Viadutos	Rio Grande do Sul
Viamão	Rio Grande do Sul
Vicente Dutra	Rio Grande do Sul
Victor Graeff	Rio Grande do Sul
Vila Flores	Rio Grande do Sul
Vila Lângaro	Rio Grande do Sul
Vila Maria	Rio Grande do Sul
Vila Nova do Sul	Rio Grande do Sul
Vista Alegre	Rio Grande do Sul
Vista Alegre do Prata	Rio Grande do Sul
Vista Gaúcha	Rio Grande do Sul
Vitória das Missões	Rio Grande do Sul
Westfália	Rio Grande do Sul
Xangri-lá	Rio Grande do Sul
Água Clara	Mato Grosso do Sul
Alcinópolis	Mato Grosso do Sul
Amambai	Mato Grosso do Sul
Anastácio	Mato Grosso do Sul
Anaurilândia	Mato Grosso do Sul
Angélica	Mato Grosso do Sul
Antônio João	Mato Grosso do Sul
Aparecida do Taboado	Mato Grosso do Sul
Aquidauana	Mato Grosso do Sul
Aral Moreira	Mato Grosso do Sul
Bandeirantes	Mato Grosso do Sul
Bataguassu	Mato Grosso do Sul
Batayporã	Mato Grosso do Sul
Bela Vista	Mato Grosso do Sul
Bodoquena	Mato Grosso do Sul
Bonito	Mato Grosso do Sul
Brasilândia	Mato Grosso do Sul
Caarapó	Mato Grosso do Sul
Camapuã	Mato Grosso do Sul
Campo Grande	Mato Grosso do Sul
Caracol	Mato Grosso do Sul
Cassilândia	Mato Grosso do Sul
Chapadão do Sul	Mato Grosso do Sul
Corguinho	Mato Grosso do Sul
Coronel Sapucaia	Mato Grosso do Sul
Corumbá	Mato Grosso do Sul
Costa Rica	Mato Grosso do Sul
Coxim	Mato Grosso do Sul
Deodápolis	Mato Grosso do Sul
Dois Irmãos do Buriti	Mato Grosso do Sul
Douradina	Mato Grosso do Sul
Dourados	Mato Grosso do Sul
Eldorado	Mato Grosso do Sul
Fátima do Sul	Mato Grosso do Sul
Figueirão	Mato Grosso do Sul
Glória de Dourados	Mato Grosso do Sul
Guia Lopes da Laguna	Mato Grosso do Sul
Iguatemi	Mato Grosso do Sul
Inocência	Mato Grosso do Sul
Itaporã	Mato Grosso do Sul
Itaquiraí	Mato Grosso do Sul
Ivinhema	Mato Grosso do Sul
Japorã	Mato Grosso do Sul
Jaraguari	Mato Grosso do Sul
Jardim	Mato Grosso do Sul
Jateí	Mato Grosso do Sul
Juti	Mato Grosso do Sul
Ladário	Mato Grosso do Sul
Laguna Carapã	Mato Grosso do Sul
Maracaju	Mato Grosso do Sul
Miranda	Mato Grosso do Sul
Mundo Novo	Mato Grosso do Sul
Naviraí	Mato Grosso do Sul
Nioaque	Mato Grosso do Sul
Nova Alvorada do Sul	Mato Grosso do Sul
Nova Andradina	Mato Grosso do Sul
Novo Horizonte do Sul	Mato Grosso do Sul
Paraíso das Águas	Mato Grosso do Sul
Paranaíba	Mato Grosso do Sul
Paranhos	Mato Grosso do Sul
Pedro Gomes	Mato Grosso do Sul
Ponta Porã	Mato Grosso do Sul
Porto Murtinho	Mato Grosso do Sul
Ribas do Rio Pardo	Mato Grosso do Sul
Rio Brilhante	Mato Grosso do Sul
Rio Negro	Mato Grosso do Sul
Rio Verde de Mato Grosso	Mato Grosso do Sul
Rochedo	Mato Grosso do Sul
Santa Rita do Pardo	Mato Grosso do Sul
São Gabriel do Oeste	Mato Grosso do Sul
Selvíria	Mato Grosso do Sul
Sete Quedas	Mato Grosso do Sul
Sidrolândia	Mato Grosso do Sul
Sonora	Mato Grosso do Sul
Tacuru	Mato Grosso do Sul
Taquarussu	Mato Grosso do Sul
Terenos	Mato Grosso do Sul
Três Lagoas	Mato Grosso do Sul
Vicentina	Mato Grosso do Sul
Acorizal	Mato Grosso
Água Boa	Mato Grosso
Alta Floresta	Mato Grosso
Alto Araguaia	Mato Grosso
Alto Boa Vista	Mato Grosso
Alto Garças	Mato Grosso
Alto Paraguai	Mato Grosso
Alto Taquari	Mato Grosso
Apiacás	Mato Grosso
Araguaiana	Mato Grosso
Araguainha	Mato Grosso
Araputanga	Mato Grosso
Arenápolis	Mato Grosso
Aripuanã	Mato Grosso
Barão de Melgaço	Mato Grosso
Barra do Bugres	Mato Grosso
Barra do Garças	Mato Grosso
Bom Jesus do Araguaia	Mato Grosso
Brasnorte	Mato Grosso
Cáceres	Mato Grosso
Campinápolis	Mato Grosso
Campo Novo do Parecis	Mato Grosso
Campo Verde	Mato Grosso
Campos de Júlio	Mato Grosso
Canabrava do Norte	Mato Grosso
Canarana	Mato Grosso
Carlinda	Mato Grosso
Castanheira	Mato Grosso
Chapada dos Guimarães	Mato Grosso
Cláudia	Mato Grosso
Cocalinho	Mato Grosso
Colíder	Mato Grosso
Colniza	Mato Grosso
Comodoro	Mato Grosso
Confresa	Mato Grosso
Conquista D'Oeste	Mato Grosso
Cotriguaçu	Mato Grosso
Cuiabá	Mato Grosso
Curvelândia	Mato Grosso
Denise	Mato Grosso
Diamantino	Mato Grosso
Dom Aquino	Mato Grosso
Feliz Natal	Mato Grosso
Figueirópolis D'Oeste	Mato Grosso
Gaúcha do Norte	Mato Grosso
General Carneiro	Mato Grosso
Glória D'Oeste	Mato Grosso
Guarantã do Norte	Mato Grosso
Guiratinga	Mato Grosso
Indiavaí	Mato Grosso
Ipiranga do Norte	Mato Grosso
Itanhangá	Mato Grosso
Itaúba	Mato Grosso
Itiquira	Mato Grosso
Jaciara	Mato Grosso
Jangada	Mato Grosso
Jauru	Mato Grosso
Juara	Mato Grosso
Juína	Mato Grosso
Juruena	Mato Grosso
Juscimeira	Mato Grosso
Lambari D'Oeste	Mato Grosso
Lucas do Rio Verde	Mato Grosso
Luciara	Mato Grosso
Marcelândia	Mato Grosso
Matupá	Mato Grosso
Mirassol d'Oeste	Mato Grosso
Nobres	Mato Grosso
Nortelândia	Mato Grosso
Nossa Senhora do Livramento	Mato Grosso
Nova Bandeirantes	Mato Grosso
Nova Brasilândia	Mato Grosso
Nova Canaã do Norte	Mato Grosso
Nova Guarita	Mato Grosso
Nova Lacerda	Mato Grosso
Nova Marilândia	Mato Grosso
Nova Maringá	Mato Grosso
Nova Monte Verde	Mato Grosso
Nova Mutum	Mato Grosso
Nova Nazaré	Mato Grosso
Nova Olímpia	Mato Grosso
Nova Santa Helena	Mato Grosso
Nova Ubiratã	Mato Grosso
Nova Xavantina	Mato Grosso
Novo Horizonte do Norte	Mato Grosso
Novo Mundo	Mato Grosso
Novo Santo Antônio	Mato Grosso
Novo São Joaquim	Mato Grosso
Paranaíta	Mato Grosso
Paranatinga	Mato Grosso
Pedra Preta	Mato Grosso
Peixoto de Azevedo	Mato Grosso
Planalto da Serra	Mato Grosso
Poconé	Mato Grosso
Pontal do Araguaia	Mato Grosso
Ponte Branca	Mato Grosso
Pontes e Lacerda	Mato Grosso
Porto Alegre do Norte	Mato Grosso
Porto dos Gaúchos	Mato Grosso
Porto Esperidião	Mato Grosso
Porto Estrela	Mato Grosso
Poxoréu	Mato Grosso
Primavera do Leste	Mato Grosso
Querência	Mato Grosso
Reserva do Cabaçal	Mato Grosso
Ribeirão Cascalheira	Mato Grosso
Ribeirãozinho	Mato Grosso
Rio Branco	Mato Grosso
Rondolândia	Mato Grosso
Rondonópolis	Mato Grosso
Rosário Oeste	Mato Grosso
Salto do Céu	Mato Grosso
Santa Carmem	Mato Grosso
Santa Cruz do Xingu	Mato Grosso
Santa Rita do Trivelato	Mato Grosso
Santa Terezinha	Mato Grosso
Santo Afonso	Mato Grosso
Santo Antônio do Leste	Mato Grosso
Santo Antônio do Leverger	Mato Grosso
São Félix do Araguaia	Mato Grosso
São José do Povo	Mato Grosso
São José do Rio Claro	Mato Grosso
São José do Xingu	Mato Grosso
São José dos Quatro Marcos	Mato Grosso
São Pedro da Cipa	Mato Grosso
Sapezal	Mato Grosso
Serra Nova Dourada	Mato Grosso
Sinop	Mato Grosso
Sorriso	Mato Grosso
Tabaporã	Mato Grosso
Tangará da Serra	Mato Grosso
Tapurah	Mato Grosso
Terra Nova do Norte	Mato Grosso
Tesouro	Mato Grosso
Torixoréu	Mato Grosso
União do Sul	Mato Grosso
Vale de São Domingos	Mato Grosso
Várzea Grande	Mato Grosso
Vera	Mato Grosso
Vila Bela da Santíssima Trindade	Mato Grosso
Vila Rica	Mato Grosso
Abadia de Goiás	Goiás
Abadiânia	Goiás
Acreúna	Goiás
Adelândia	Goiás
Água Fria de Goiás	Goiás
Água Limpa	Goiás
Águas Lindas de Goiás	Goiás
Alexânia	Goiás
Aloândia	Goiás
Alto Horizonte	Goiás
Alto Paraíso de Goiás	Goiás
Alvorada do Norte	Goiás
Amaralina	Goiás
Americano do Brasil	Goiás
Amorinópolis	Goiás
Anápolis	Goiás
Anhanguera	Goiás
Anicuns	Goiás
Aparecida de Goiânia	Goiás
Aparecida do Rio Doce	Goiás
Aporé	Goiás
Araçu	Goiás
Aragarças	Goiás
Aragoiânia	Goiás
Araguapaz	Goiás
Arenópolis	Goiás
Aruanã	Goiás
Aurilândia	Goiás
Avelinópolis	Goiás
Baliza	Goiás
Barro Alto	Goiás
Bela Vista de Goiás	Goiás
Bom Jardim de Goiás	Goiás
Bom Jesus de Goiás	Goiás
Bonfinópolis	Goiás
Bonópolis	Goiás
Brazabrantes	Goiás
Britânia	Goiás
Buriti Alegre	Goiás
Buriti de Goiás	Goiás
Buritinópolis	Goiás
Cabeceiras	Goiás
Cachoeira Alta	Goiás
Cachoeira de Goiás	Goiás
Cachoeira Dourada	Goiás
Caçu	Goiás
Caiapônia	Goiás
Caldas Novas	Goiás
Caldazinha	Goiás
Campestre de Goiás	Goiás
Campinaçu	Goiás
Campinorte	Goiás
Campo Alegre de Goiás	Goiás
Campo Limpo de Goiás	Goiás
Campos Belos	Goiás
Campos Verdes	Goiás
Carmo do Rio Verde	Goiás
Castelândia	Goiás
Catalão	Goiás
Caturaí	Goiás
Cavalcante	Goiás
Ceres	Goiás
Cezarina	Goiás
Chapadão do Céu	Goiás
Cidade Ocidental	Goiás
Cocalzinho de Goiás	Goiás
Colinas do Sul	Goiás
Córrego do Ouro	Goiás
Corumbá de Goiás	Goiás
Corumbaíba	Goiás
Cristalina	Goiás
Cristianópolis	Goiás
Crixás	Goiás
Cromínia	Goiás
Cumari	Goiás
Damianópolis	Goiás
Damolândia	Goiás
Davinópolis	Goiás
Diorama	Goiás
Divinópolis de Goiás	Goiás
Doverlândia	Goiás
Edealina	Goiás
Edéia	Goiás
Estrela do Norte	Goiás
Faina	Goiás
Fazenda Nova	Goiás
Firminópolis	Goiás
Flores de Goiás	Goiás
Formosa	Goiás
Formoso	Goiás
Gameleira de Goiás	Goiás
Goianápolis	Goiás
Goiandira	Goiás
Goianésia	Goiás
Goiânia	Goiás
Goianira	Goiás
Goiás	Goiás
Goiatuba	Goiás
Gouvelândia	Goiás
Guapó	Goiás
Guaraíta	Goiás
Guarani de Goiás	Goiás
Guarinos	Goiás
Heitoraí	Goiás
Hidrolândia	Goiás
Hidrolina	Goiás
Iaciara	Goiás
Inaciolândia	Goiás
Indiara	Goiás
Inhumas	Goiás
Ipameri	Goiás
Ipiranga de Goiás	Goiás
Iporá	Goiás
Israelândia	Goiás
Itaberaí	Goiás
Itaguari	Goiás
Itaguaru	Goiás
Itajá	Goiás
Itapaci	Goiás
Itapirapuã	Goiás
Itapuranga	Goiás
Itarumã	Goiás
Itauçu	Goiás
Itumbiara	Goiás
Ivolândia	Goiás
Jandaia	Goiás
Jaraguá	Goiás
Jataí	Goiás
Jaupaci	Goiás
Jesúpolis	Goiás
Joviânia	Goiás
Jussara	Goiás
Lagoa Santa	Goiás
Leopoldo de Bulhões	Goiás
Luziânia	Goiás
Mairipotaba	Goiás
Mambaí	Goiás
Mara Rosa	Goiás
Marzagão	Goiás
Matrinchã	Goiás
Maurilândia	Goiás
Mimoso de Goiás	Goiás
Minaçu	Goiás
Mineiros	Goiás
Moiporá	Goiás
Monte Alegre de Goiás	Goiás
Montes Claros de Goiás	Goiás
Montividiu	Goiás
Montividiu do Norte	Goiás
Morrinhos	Goiás
Morro Agudo de Goiás	Goiás
Mossâmedes	Goiás
Mozarlândia	Goiás
Mundo Novo	Goiás
Mutunópolis	Goiás
Nazário	Goiás
Nerópolis	Goiás
Niquelândia	Goiás
Nova América	Goiás
Nova Aurora	Goiás
Nova Crixás	Goiás
Nova Glória	Goiás
Nova Iguaçu de Goiás	Goiás
Nova Roma	Goiás
Nova Veneza	Goiás
Novo Brasil	Goiás
Novo Gama	Goiás
Novo Planalto	Goiás
Orizona	Goiás
Ouro Verde de Goiás	Goiás
Ouvidor	Goiás
Padre Bernardo	Goiás
Palestina de Goiás	Goiás
Palmeiras de Goiás	Goiás
Palmelo	Goiás
Palminópolis	Goiás
Panamá	Goiás
Paranaiguara	Goiás
Paraúna	Goiás
Perolândia	Goiás
Petrolina de Goiás	Goiás
Pilar de Goiás	Goiás
Piracanjuba	Goiás
Piranhas	Goiás
Pirenópolis	Goiás
Pires do Rio	Goiás
Planaltina	Goiás
Pontalina	Goiás
Porangatu	Goiás
Porteirão	Goiás
Portelândia	Goiás
Posse	Goiás
Professor Jamil	Goiás
Quirinópolis	Goiás
Rialma	Goiás
Rianápolis	Goiás
Rio Quente	Goiás
Rio Verde	Goiás
Rubiataba	Goiás
Sanclerlândia	Goiás
Santa Bárbara de Goiás	Goiás
Santa Cruz de Goiás	Goiás
Santa Fé de Goiás	Goiás
Santa Helena de Goiás	Goiás
Santa Isabel	Goiás
Santa Rita do Araguaia	Goiás
Santa Rita do Novo Destino	Goiás
Santa Rosa de Goiás	Goiás
Santa Tereza de Goiás	Goiás
Santa Terezinha de Goiás	Goiás
Santo Antônio da Barra	Goiás
Santo Antônio de Goiás	Goiás
Santo Antônio do Descoberto	Goiás
São Domingos	Goiás
São Francisco de Goiás	Goiás
São João da Paraúna	Goiás
São João d'Aliança	Goiás
São Luís de Montes Belos	Goiás
São Luiz do Norte	Goiás
São Miguel do Araguaia	Goiás
São Miguel do Passa Quatro	Goiás
São Patrício	Goiás
São Simão	Goiás
Senador Canedo	Goiás
Serranópolis	Goiás
Silvânia	Goiás
Simolândia	Goiás
Sítio d'Abadia	Goiás
Taquaral de Goiás	Goiás
Teresina de Goiás	Goiás
Terezópolis de Goiás	Goiás
Três Ranchos	Goiás
Trindade	Goiás
Trombas	Goiás
Turvânia	Goiás
Turvelândia	Goiás
Uirapuru	Goiás
Uruaçu	Goiás
Uruana	Goiás
Urutaí	Goiás
Valparaíso de Goiás	Goiás
Varjão	Goiás
Vianópolis	Goiás
Vicentinópolis	Goiás
Vila Boa	Goiás
Vila Propício	Goiás
Brasília	Distrito Federal
